CAGTATTACAGCCAGCCCGATATTTGCCCT|TAAATGGGTGACGGTAAAGACGTACCTGGA
TCGGTCGAAAGAGTGGACGTCCGTGCACAA|ACAGTATCGAAGCTATCACTTATTTGGTCG
CGACCTGCGTCGCAGTAATCGTTTAAGAGT|GTATGCACAAGACAGTATCGGTCTAAAAAA
CAAAGCGAAAGAGTGGACGTCCGTGCACAA|AGTATAGAGTGGACGTCCGTGCACAAGACA
CGTCCGTGCACAAGACAGTATGTCCGGTTA|CGTGCACAAGACAGTATCATGGCACGAAAC
TGGACGTCCGTGCACAAGACAGTATCATGG|ATCGTTTAAGAGTGGACGTCCGTGCACAAG
AATCGTTTAAGAGTGGACGTCCGTGCACAA|ATCGGTCTAAAAAATTAGCGGTATTAGCAG
AGAGCACGCTTCAAAAGAACGCCATGGTAT|TTGCGTATTTGCGAAAGGGTAGGCTCGCTC
GAGTCGTCTAAAATACCAATAAAGCGCCAC|ATTCGTTAAGTTAAGGGCATTCTGTACAGG
GTATACTTTATCTAAGTTATTGAGCAGATA|AGTGGACGTCCGTGCACAAGACAGTATATG
GCAGTAATCGTTTAAGAGTGGACGTCCGTG|ACAGTATCGGTCTAAAAAATTAGCGGTATT
AAATGGGTGACGGTAAAGACGTACCTGGAA|GGACACCAGAGCAATTCATGTAGCAAGGGT
GAGAAAGAGTGGACGTCCGTGCACAAGACA|ATTTGCCCTTAACGCACCTCTCCTTTGAGT
GAGTGGACGTCCGTGCACAAGACAGTATAT|GGAAGGCCGACCTCCGCTGGTTGGGAGGTT
CAAGACAGTATTTCGTGACGGCATCGGAAC|TCCGTGAAGAGTGGACGTCCGTGCACAAGA
TGGACGTCCGTGCACAAGACAGTATCGAAG|TCCGTGCACAAGACAGTATACCTTCGCTCA
AAGAGTGGACGTCCGTGCACAAGACAGTAT|TGGACGTCCGTGCACAAGACAGTATAAATG
GGTAGCCTAAGTCGCTGGATGGAAGGGGGG|AGCAGATACGACAAGAGTGGACGTCCGTAA
AAGAGTGGACGTCCGTGCACAAGACAGTAT|GGGGGGCATATATAGCGAAGGAAAAAGCTC
GCGTCCTGAGGACCTATCGTTCCCGCTACT|TGGACGTCCGTGCACAAGACAGTATTACAG
GTATGCACAAGACAGTATCGGTCTAAAAAA|TAGTACTTACAGGCGATAAAGAGTGGACGT
ATAAAGAGTGGACGTCCGTGCACAAGACAG|TGTTGTCTTAGTCAAAACAGAGCACGCTTC
GTGGGACCAAAGCGAAAGAGTGGACGTCCG|ACAAGACAGTATAGAGTGGACGTCCGTGCA
TGACAGTTAATAATCGACCACGCTGTTGTC|ACTTTACGGAGAAAGAGTGGACGTCCGTGC
TAAAATACCAATAAAGCGCCACAAGAGCCG|AGTTAAGGGCATTCTGTACAGGAACTGGCA
AGTAATCGTTTAAGAGTGGACGTCCGTGCA|AGTATCGGTCTAAAAAATTAGCGGTATTAG
CGGCATCGGAACACTCGGAGTGGGACCAAA|CCGTGCACAAGACAGTATCACAAGACAGTA
GAGTGGACGTCCGTAAGAGTGGACGTCCGT|CTAAAATACCAATAAAGCGCCACAAGAGCC
AGTATGTATACTTTATCTAAGTTATTGAGC|CAAAGAGTGGACGTCCGTGCACAAGACAGT
GCACGAAACTCACGCGTAGTTCCTACCCTG|GACAGTATGTATACTTTATCTAAGTTATTG
TGGACGTCCGTAAGAGTGGACGTCCGTGCA|AAATACCAATAAAGCGCCACAAGAGCCGGG
CCGGCCACACTGTTCTCGCAAGGTCTAAAA|TCCGGTTAAAACACATAACATCTATCGGAA
AAGAGTGGACGTCCGTGCACAAGACAGTAT|GTGGACGTCCGTGCACAAGACAGTATCATG
AGCGCCACAAGAGCCGGGAGTCTCATAGTA|TGTACAGGAACTGGCAGTGACAGTTAATAA
TTGGTCGGTTCGTAGGGACACCAGAGCAAT|AAGGTGCGTAGGGTTGACGACGTAAGGTTA
TTCTGAACACTGGCATAGCCTTATTCGAAT|AACACTCGGAGTGGGACCAAAGCGAAAGAG
GGACGTCCGTGCACAAGACAGTATCATGGC|TCGTTTAAGAGTGGACGTCCGTGCACAAGA
GCCATGGTATGTGCAGTTGTCGACATACTT|AGGCTCGCTCGGTAGCTTGGCAGATACAGC
GCTCCGACCTGCGTCGCAGTAATCGTTTAA|GACAGTATGCACAAGACAGTATCGGTCTAA
GACAGTATATGAGTCGTCTAAAATACCAAT|TTGGGAGGTTATTCGTTAAGTTAAGGGCAT
CATAGCCTTATTCGAATATAAATGATCAGT|GGACCAAAGCGAAAGAGTGGACGTCCGTGC
GCGTGCGTCCTGAGGACCTATCGTTCCCGC|AGAGTGGACGTCCGTGCACAAGACAGTATT
AAGACAGTATGTATACTTTATCTAAGTTAT|AGCCACAAAGAGTGGACGTCCGTGCACAAG
AGTGGACGTCCGTGCACAAGACAGTATCAT|TAATCGTTTAAGAGTGGACGTCCGTGCACA
GCACAAGACAGTATGTCCGGTTAAAACACA|AAGACAGTATCATGGCACGAAACTCACGCG
ACCGGGCTATTCTGAACACTGGCATAGCCT|CGGCATCGGAACACTCGGAGTGGGACCAAA
ATCATGGCACGAAACTCACGCGTAGTTCCT|GCACAAGACAGTATGTATACTTTATCTAAG
CTTTGAGTGAGCAAGCACCCTTACATGAGG|TCGTGGCAGATTCAGGATTTTCTAGGTAAG
TGCCACTGCGTGCCTCTTCGGTCGAAAGAG|GGACGTCCGTGCACAAGACAGTATCGAAGC
TGGCAGTGACAGTTAATAATCGACCACGCT|TACTTGACTTTACGGAGAAAGAGTGGACGT
TTCTCGCAAGGTCTAAAAGAGTGGACGTCC|ACATAACATCTATCGGAATGCCTAAAGAGT
TGGGTGACGGTAAAGACGTACCTGGAAACT|CACCAGAGCAATTCATGTAGCAAGGGTAAG
TATCGAAGCTATCACTTATTTGGTCGGTTC|TTCGCTCAGGGATGGCACAAAGGTGCGTAG
CTGGCAGTGACAGTTAATAATCGACCACGC|CTACTTGACTTTACGGAGAAAGAGTGGACG
CCAAAGCGAAAGAGTGGACGTCCGTGCACA|CAGTATAGAGTGGACGTCCGTGCACAAGAC
AAGACAGTATGTCCGGTTAAAACACATAAC|CAGTATCATGGCACGAAACTCACGCGTAGT
CATTCTGTACAGGAACTGGCAGTGACAGTT|GACCTATCGTTCCCGCTACTTGACTTTACG
TATCACTTATTTGGTCGGTTCGTAGGGACA|GGATGGCACAAAGGTGCGTAGGGTTGACGA
GGTTATTCGTTAAGTTAAGGGCATTCTGTA|ACTTACAGCGTGCGTCCTGAGGACCTATCG
AGAGTGGACGTCCGTGCACAAGACAGTATC|AGTAATCGTTTAAGAGTGGACGTCCGTGCA
TTGAGCAGATACGACAAGAGTGGACGTCCG|GACAGTATATGAGTCGTCTAAAATACCAAT
TATAGAGTGGACGTCCGTGCACAAGACAGT|CGCAGTAATCGTTTAAGAGTGGACGTCCGT
AGTATCACAAGACAGTATAGAGTGGACGTC|AGCTCCGACCTGCGTCGCAGTAATCGTTTA
GAGTGGACGTCCGTGCACAAGACAGTATCA|GTAATCGTTTAAGAGTGGACGTCCGTGCAC
ATTTCGTGACGGCATCGGAACACTCGGAGT|AGTGGACGTCCGTGCACAAGACAGTATCAC
CACAAGACAGTATCATGGCACGAAACTCAC|TGGACGTCCGTGCACAAGACAGTATGTATA
GGATGGAAGGGGGGCATATATAGCGAAGGA|GTGGACGTCCGTAAGAGTGGACGTCCGTGC
CAAGAGCCGGGAGTCTCATAGTACTTACAG|GAACTGGCAGTGACAGTTAATAATCGACCA
AAGACAGTATTTCGTGACGGCATCGGAACA|CCGTGAAGAGTGGACGTCCGTGCACAAGAC
CTTATTTGGTCGGTTCGTAGGGACACCAGA|GCACAAAGGTGCGTAGGGTTGACGACGTAA
AAAAGCTCCGACCTGCGTCGCAGTAATCGT|ACAAGACAGTATGCACAAGACAGTATCGGT
TCATGGCACGAAACTCACGCGTAGTTCCTA|CACAAGACAGTATGTATACTTTATCTAAGT
GACGTCCGTGAAGAGTGGACGTCCGTGCAC|CTGGATGGAAGGGGGGCATATATAGCGAAG
CTAAAGAGTGGACGTCCGTGAAGAGTGGAC|GCCTAAGTCGCTGGATGGAAGGGGGGCATA
GCTTGGCAGATACAGCGTAAGAGTGGACGT|CCTCTTCGGTCGAAAGAGTGGACGTCCGTG
GGCATATATAGCGAAGGAAAAAGCTCCGAC|AAGAGTGGACGTCCGTGCACAAGACAGTAT
TGCGTGCCTCTTCGGTCGAAAGAGTGGACG|CCGTGCACAAGACAGTATCGAAGCTATCAC
CTGTACAGGAACTGGCAGTGACAGTTAATA|TATCGTTCCCGCTACTTGACTTTACGGAGA
ACGTCCGTAAGAGTGGACGTCCGTGCACAA|TACCAATAAAGCGCCACAAGAGCCGGGAGT
ATGCCACTGCGTGCCTCTTCGGTCGAAAGA|TGGACGTCCGTGCACAAGACAGTATCGAAG
AATATAAATGATCAGTCCACTGATACAATC|GAGTGGACGTCCGTGCACAAGACAGTATGT
GAGGTCATGCCACTGCGTGCCTCTTCGGTC|TAAGAGTGGACGTCCGTGCACAAGACAGTA
TGGTTGGGAGGTTATTCGTTAAGTTAAGGG|TGTCGACATACTTACAGCGTGCGTCCTGAG
GCAGCCACAAAGAGTGGACGTCCGTGCACA|CAGTATCGAGTGGAAGGCCGACCTCCGCTG
CGAGTGGAAGGCCGACCTCCGCTGGTTGGG|AGAACGCCATGGTATGTGCAGTTGTCGACA
GCCACACTGTTCTCGCAAGGTCTAAAAGAG|GGTTAAAACACATAACATCTATCGGAATGC
CCGCTACTTGACTTTACGGAGAAAGAGTGG|TATTACAGCCAGCCCGATATTTGCCCTTAA
GTCCGTGCACAAGACAGTATCACAAGACAG|TATAGCGAAGGAAAAAGCTCCGACCTGCGT
CACGCTTCAAAAGAACGCCATGGTATGTGC|GTATTTGCGAAAGGGTAGGCTCGCTCGGTA
CCGTGCACAAGACAGTATGTCCGGTTAAAA|GCACAAGACAGTATCATGGCACGAAACTCA
CAAGACAGTATAAATGGGTGACGGTAAAGA|TCGGTTCGTAGGGACACCAGAGCAATTCAT
CACAAAGAGTGGACGTCCGTGCACAAGACA|TCGAGTGGAAGGCCGACCTCCGCTGGTTGG
ATAAATGATCAGTCCACTGATACAATCCGG|TGGACGTCCGTGCACAAGACAGTATGTCCG
TGGCATAGCCTTATTCGAATATAAATGATC|GTGGGACCAAAGCGAAAGAGTGGACGTCCG
CGATAAAGAGTGGACGTCCGTGCACAAGAC|GCTGTTGTCTTAGTCAAAACAGAGCACGCT
CCGACCTGCGTCGCAGTAATCGTTTAAGAG|AGTATGCACAAGACAGTATCGGTCTAAAAA
ATTAGCGGTATTAGCAGCCACAAAGAGTGG|TCCGTGCACAAGACAGTATCGAGTGGAAGG
TGCACAAGACAGTATCGAAGCTATCACTTA|AGACAGTATACCTTCGCTCAGGGATGGCAC
CAGCGTGCGTCCTGAGGACCTATCGTTCCC|TAAGAGTGGACGTCCGTGCACAAGACAGTA
TTTATCTAAGTTATTGAGCAGATACGACAA|CGTCCGTGCACAAGACAGTATATGAGTCGT
GACGGTAAAGACGTACCTGGAAACTTCAGG|GAGCAATTCATGTAGCAAGGGTAAGATAAA
AAAGAGTGGACGTCCGTGCACAAGACAGTA|AGTGGACGTCCGTGCACAAGACAGTATCAT
GCCACAAGAGCCGGGAGTCTCATAGTACTT|ACAGGAACTGGCAGTGACAGTTAATAATCG
GCCGACCTCCGCTGGTTGGGAGGTTATTCG|GGTATGTGCAGTTGTCGACATACTTACAGC
GAAAGAGTGGACGTCCGTGCACAAGACAGT|TCGAAGCTATCACTTATTTGGTCGGTTCGT
TAAGTCGCTGGATGGAAGGGGGGCATATAT|ACGACAAGAGTGGACGTCCGTAAGAGTGGA
GACAGTATCGAGTGGAAGGCCGACCTCCGC|GCTTCAAAAGAACGCCATGGTATGTGCAGT
TTGTCTTAGTCAAAACAGAGCACGCTTCAA|CGTGCACAAGACAGTATTGCGTATTTGCGA
ACCCTTACATGAGGTCATGCCACTGCGTGC|ATTTTCTAGGTAAGAGTGGACGTCCGTGCA
GACGTCCGTGCACAAGACAGTATCATGGCA|CGTTTAAGAGTGGACGTCCGTGCACAAGAC
AAGGGGGGCATATATAGCGAAGGAAAAAGC|GTCCGTAAGAGTGGACGTCCGTGCACAAGA
AATGCCTAAAGAGTGGACGTCCGTGAAGAG|GGGTAGCCTAAGTCGCTGGATGGAAGGGGG
TGCACAAGACAGTATTGCGTATTTGCGAAA|CTCCTTTGAGTGAGCAAGCACCCTTACATG
CTGAACACTGGCATAGCCTTATTCGAATAT|CACTCGGAGTGGGACCAAAGCGAAAGAGTG
AGACAGTATCACAAGACAGTATAGAGTGGA|AAAAAGCTCCGACCTGCGTCGCAGTAATCG
GGGGCATATATAGCGAAGGAAAAAGCTCCG|GTAAGAGTGGACGTCCGTGCACAAGACAGT
TCAAAACAGAGCACGCTTCAAAAGAACGCC|GACAGTATTGCGTATTTGCGAAAGGGTAGG
GAAACTTCAGGAAATTCGTGGCAGATTCAG|GGTAAGATAAAACGATAGCACGTTGACGCA
ACACATAACATCTATCGGAATGCCTAAAGA|ACGCGTAGTTCCTACCCTGGGTAGCCTAAG
GTTAAAACACATAACATCTATCGGAATGCC|AAACTCACGCGTAGTTCCTACCCTGGGTAG
ACATGAGGTCATGCCACTGCGTGCCTCTTC|TAGGTAAGAGTGGACGTCCGTGCACAAGAC
TCGTTAAGTTAAGGGCATTCTGTACAGGAA|AGCGTGCGTCCTGAGGACCTATCGTTCCCG
TAGTACTTACAGGCGATAAAGAGTGGACGT|AATAATCGACCACGCTGTTGTCTTAGTCAA
ATCGAAGCTATCACTTATTTGGTCGGTTCG|TCGCTCAGGGATGGCACAAAGGTGCGTAGG
CTGAGGACCTATCGTTCCCGCTACTTGACT|GTCCGTGCACAAGACAGTATTACAGCCAGC
TAAAGACGTACCTGGAAACTTCAGGAAATT|ATTCATGTAGCAAGGGTAAGATAAAACGAT
GAAAGAGTGGACGTCCGTGCACAAGACAGT|GAGTGGACGTCCGTGCACAAGACAGTATCA
GCCAGCCCGATATTTGCCCTTAACGCACCT|ACGGTAAAGACGTACCTGGAAACTTCAGGA
TGTATACTTTATCTAAGTTATTGAGCAGAT|GAGTGGACGTCCGTGCACAAGACAGTATAT
AATGGGTGACGGTAAAGACGTACCTGGAAA|GACACCAGAGCAATTCATGTAGCAAGGGTA
GGTTAAAACACATAACATCTATCGGAATGC|GAAACTCACGCGTAGTTCCTACCCTGGGTA
GTGGACGTCCGTGCACAAGACAGTATGTCC|ACGTCCGTGCACAAGACAGTATCATGGCAC
GTATATGAGTCGTCTAAAATACCAATAAAG|GAGGTTATTCGTTAAGTTAAGGGCATTCTG
TGTCTTAGTCAAAACAGAGCACGCTTCAAA|GTGCACAAGACAGTATTGCGTATTTGCGAA
GGCAGATACAGCGTAAGAGTGGACGTCCGT|TTCGGTCGAAAGAGTGGACGTCCGTGCACA
ACGCTGTTGTCTTAGTCAAAACAGAGCACG|GACGTCCGTGCACAAGACAGTATTGCGTAT
GGAGAAAGAGTGGACGTCCGTGCACAAGAC|TATTTGCCCTTAACGCACCTCTCCTTTGAG
GACAGTATCATGGCACGAAACTCACGCGTA|GTCCGTGCACAAGACAGTATGTATACTTTA
TATAGCGAAGGAAAAAGCTCCGACCTGCGT|GGACGTCCGTGCACAAGACAGTATGCACAA
AGTGGACGTCCGTGCACAAGACAGTATATG|GAAGGCCGACCTCCGCTGGTTGGGAGGTTA
TAGTTCCTACCCTGGGTAGCCTAAGTCGCT|TATCTAAGTTATTGAGCAGATACGACAAGA
GGACGTCCGTGCACAAGACAGTATGTATAC|TTAGCGGTATTAGCAGCCACAAAGAGTGGA
ACGTCCGTGAAGAGTGGACGTCCGTGCACA|TGGATGGAAGGGGGGCATATATAGCGAAGG
GTAAGAGTGGACGTCCGTGCACAAGACAGT|AGTGGACGTCCGTGCACAAGACAGTATAAA
GAATATAAATGATCAGTCCACTGATACAAT|AGAGTGGACGTCCGTGCACAAGACAGTATG
TAGGCTCGCTCGGTAGCTTGGCAGATACAG|TCATGCCACTGCGTGCCTCTTCGGTCGAAA
TCCGACCTGCGTCGCAGTAATCGTTTAAGA|CAGTATGCACAAGACAGTATCGGTCTAAAA
CAGTATCGAAGCTATCACTTATTTGGTCGG|ACCTTCGCTCAGGGATGGCACAAAGGTGCG
ATATAGCGAAGGAAAAAGCTCCGACCTGCG|TGGACGTCCGTGCACAAGACAGTATGCACA
GACAGTATAAATGGGTGACGGTAAAGACGT|GTTCGTAGGGACACCAGAGCAATTCATGTA
CCGTGAAGAGTGGACGTCCGTGCACAAGAC|TGGAAGGGGGGCATATATAGCGAAGGAAAA
GAAGGAAAAAGCTCCGACCTGCGTCGCAGT|CCGTGCACAAGACAGTATGCACAAGACAGT
GTGGACGTCCGTGCACAAGACAGTATCATG|AATCGTTTAAGAGTGGACGTCCGTGCACAA
AGTTGTCGACATACTTACAGCGTGCGTCCT|GCTTGGCAGATACAGCGTAAGAGTGGACGT
CACACTGTTCTCGCAAGGTCTAAAAGAGTG|TTAAAACACATAACATCTATCGGAATGCCT
CTCGGTAGCTTGGCAGATACAGCGTAAGAG|CTGCGTGCCTCTTCGGTCGAAAGAGTGGAC
CAGCCACAAAGAGTGGACGTCCGTGCACAA|AGTATCGAGTGGAAGGCCGACCTCCGCTGG
TGGCAGATTCAGGATTTTCTAGGTAAGAGT|CACGTTGACGCAAATGAAAAGAGTGGACGT
TTGCCCTTAACGCACCTCTCCTTTGAGTGA|ACCTGGAAACTTCAGGAAATTCGTGGCAGA
AACGCACCTCTCCTTTGAGTGAGCAAGCAC|ACTTCAGGAAATTCGTGGCAGATTCAGGAT
TCTCGCAAGGTCTAAAAGAGTGGACGTCCG|CATAACATCTATCGGAATGCCTAAAGAGTG
CCATGGTATGTGCAGTTGTCGACATACTTA|GGCTCGCTCGGTAGCTTGGCAGATACAGCG
CGTGCACAAGACAGTATATGAGTCGTCTAA|CTCCGCTGGTTGGGAGGTTATTCGTTAAGT
GTATAAATGGGTGACGGTAAAGACGTACCT|GTAGGGACACCAGAGCAATTCATGTAGCAA
TGATACAATCCGGCCACACTGTTCTCGCAA|GACAGTATGTCCGGTTAAAACACATAACAT
AACTTCAGGAAATTCGTGGCAGATTCAGGA|TAAGATAAAACGATAGCACGTTGACGCAAA
CTTTATCTAAGTTATTGAGCAGATACGACA|ACGTCCGTGCACAAGACAGTATATGAGTCG
CTTGGCAGATACAGCGTAAGAGTGGACGTC|CTCTTCGGTCGAAAGAGTGGACGTCCGTGC
GGAGGTTATTCGTTAAGTTAAGGGCATTCT|CATACTTACAGCGTGCGTCCTGAGGACCTA
GTGGACGTCCGTAAGAGTGGACGTCCGTGC|AAAATACCAATAAAGCGCCACAAGAGCCGG
ACAGTATCATGGCACGAAACTCACGCGTAG|TCCGTGCACAAGACAGTATGTATACTTTAT
TGCACAAGACAGTATCGGTCTAAAAAATTA|TACTTACAGGCGATAAAGAGTGGACGTCCG
CGCAGTAATCGTTTAAGAGTGGACGTCCGT|GACAGTATCGGTCTAAAAAATTAGCGGTAT
CAGGATTTTCTAGGTAAGAGTGGACGTCCG|GCAAATGAAAAGAGTGGACGTCCGTGCACA
AATCCGGCCACACTGTTCTCGCAAGGTCTA|ATGTCCGGTTAAAACACATAACATCTATCG
AGTGGACGTCCGTGAAGAGTGGACGTCCGT|GTCGCTGGATGGAAGGGGGGCATATATAGC
GGGTAGCCTAAGTCGCTGGATGGAAGGGGG|GAGCAGATACGACAAGAGTGGACGTCCGTA
AGTGGGACCAAAGCGAAAGAGTGGACGTCC|CACAAGACAGTATAGAGTGGACGTCCGTGC
ACGCCATGGTATGTGCAGTTGTCGACATAC|GTAGGCTCGCTCGGTAGCTTGGCAGATACA
CTTCAGGAAATTCGTGGCAGATTCAGGATT|AGATAAAACGATAGCACGTTGACGCAAATG
CCGTGCACAAGACAGTATATGAGTCGTCTA|CCTCCGCTGGTTGGGAGGTTATTCGTTAAG
CTGGGTAGCCTAAGTCGCTGGATGGAAGGG|TTGAGCAGATACGACAAGAGTGGACGTCCG
GTCAAAACAGAGCACGCTTCAAAAGAACGC|AGACAGTATTGCGTATTTGCGAAAGGGTAG
CACAAGACAGTATCGAAGCTATCACTTATT|ACAGTATACCTTCGCTCAGGGATGGCACAA
GGCAGATTCAGGATTTTCTAGGTAAGAGTG|ACGTTGACGCAAATGAAAAGAGTGGACGTC
GGTAGGCTCGCTCGGTAGCTTGGCAGATAC|GGTCATGCCACTGCGTGCCTCTTCGGTCGA
GTGACGGCATCGGAACACTCGGAGTGGGAC|ACGTCCGTGCACAAGACAGTATCACAAGAC
TGCACAAGACAGTATTTCGTGACGGCATCG|GACGTCCGTGAAGAGTGGACGTCCGTGCAC
CGTGCACAAGACAGTATGTATACTTTATCT|TATTAGCAGCCACAAAGAGTGGACGTCCGT
AGGAAAAAGCTCCGACCTGCGTCGCAGTAA|GTGCACAAGACAGTATGCACAAGACAGTAT
ACAAGACAGTATTGCGTATTTGCGAAAGGG|CTTTGAGTGAGCAAGCACCCTTACATGAGG
GTTAAGGGCATTCTGTACAGGAACTGGCAG|GTCCTGAGGACCTATCGTTCCCGCTACTTG
AAGACAGTATTACAGCCAGCCCGATATTTG|AGTATAAATGGGTGACGGTAAAGACGTACC
TCGAAGCTATCACTTATTTGGTCGGTTCGT|CGCTCAGGGATGGCACAAAGGTGCGTAGGG
GTCTCATAGTACTTACAGGCGATAAAGAGT|ACAGTTAATAATCGACCACGCTGTTGTCTT
CAGTATAGAGTGGACGTCCGTGCACAAGAC|CGTCGCAGTAATCGTTTAAGAGTGGACGTC
GACAGTATTTCGTGACGGCATCGGAACACT|GTGAAGAGTGGACGTCCGTGCACAAGACAG
ACACTCGGAGTGGGACCAAAGCGAAAGAGT|GACAGTATCACAAGACAGTATAGAGTGGAC
AGGTAAGAGTGGACGTCCGTGCACAAGACA|GAGTGGACGTCCGTGCACAAGACAGTATAC
TAAATGATCAGTCCACTGATACAATCCGGC|GGACGTCCGTGCACAAGACAGTATGTCCGG
ATCGGAACACTCGGAGTGGGACCAAAGCGA|GCACAAGACAGTATCACAAGACAGTATAGA
TTCAGGATTTTCTAGGTAAGAGTGGACGTC|ACGCAAATGAAAAGAGTGGACGTCCGTGCA
AGGATTTTCTAGGTAAGAGTGGACGTCCGT|CAAATGAAAAGAGTGGACGTCCGTGCACAA
AAGCACCCTTACATGAGGTCATGCCACTGC|CAGGATTTTCTAGGTAAGAGTGGACGTCCG
TAAGTTATTGAGCAGATACGACAAGAGTGG|TGCACAAGACAGTATATGAGTCGTCTAAAA
ATACAATCCGGCCACACTGTTCTCGCAAGG|CAGTATGTCCGGTTAAAACACATAACATCT
TCACGCGTAGTTCCTACCCTGGGTAGCCTA|TATACTTTATCTAAGTTATTGAGCAGATAC
GGATTTTCTAGGTAAGAGTGGACGTCCGTG|AAATGAAAAGAGTGGACGTCCGTGCACAAG
AACACTCGGAGTGGGACCAAAGCGAAAGAG|AGACAGTATCACAAGACAGTATAGAGTGGA
ACAAGACAGTATGCACAAGACAGTATCGGT|GAGTCTCATAGTACTTACAGGCGATAAAGA
GTACCTGGAAACTTCAGGAAATTCGTGGCA|TAGCAAGGGTAAGATAAAACGATAGCACGT
CGACAAGAGTGGACGTCCGTAAGAGTGGAC|AGTCGTCTAAAATACCAATAAAGCGCCACA
CGTGCACAAGACAGTATGTCCGGTTAAAAC|CACAAGACAGTATCATGGCACGAAACTCAC
TAGCGAAGGAAAAAGCTCCGACCTGCGTCG|ACGTCCGTGCACAAGACAGTATGCACAAGA
GCGTAAGAGTGGACGTCCGTGCACAAGACA|AGAGTGGACGTCCGTGCACAAGACAGTATA
GGACCTATCGTTCCCGCTACTTGACTTTAC|GTGCACAAGACAGTATTACAGCCAGCCCGA
GTATCGGTCTAAAAAATTAGCGGTATTAGC|GATAAAGAGTGGACGTCCGTGCACAAGACA
TCTGAACACTGGCATAGCCTTATTCGAATA|ACACTCGGAGTGGGACCAAAGCGAAAGAGT
TCGAATATAAATGATCAGTCCACTGATACA|AAAGAGTGGACGTCCGTGCACAAGACAGTA
CTAGGTAAGAGTGGACGTCCGTGCACAAGA|AAGAGTGGACGTCCGTGCACAAGACAGTAT
TACTTGACTTTACGGAGAAAGAGTGGACGT|ACAGCCAGCCCGATATTTGCCCTTAACGCA
TATAAATGGGTGACGGTAAAGACGTACCTG|TAGGGACACCAGAGCAATTCATGTAGCAAG
ATTCGTTAAGTTAAGGGCATTCTGTACAGG|ACAGCGTGCGTCCTGAGGACCTATCGTTCC
ATGTCCGGTTAAAACACATAACATCTATCG|TGGCACGAAACTCACGCGTAGTTCCTACCC
TATTACAGCCAGCCCGATATTTGCCCTTAA|ATGGGTGACGGTAAAGACGTACCTGGAAAC
TACTTACAGCGTGCGTCCTGAGGACCTATC|ACAGCGTAAGAGTGGACGTCCGTGCACAAG
TTCGGTCGAAAGAGTGGACGTCCGTGCACA|GACAGTATCGAAGCTATCACTTATTTGGTC
AGACAGTATCGAAGCTATCACTTATTTGGT|TATACCTTCGCTCAGGGATGGCACAAAGGT
ACTTTATCTAAGTTATTGAGCAGATACGAC|GACGTCCGTGCACAAGACAGTATATGAGTC
CGTCCGTGCACAAGACAGTATCATGGCACG|TTTAAGAGTGGACGTCCGTGCACAAGACAG
CGGTCGAAAGAGTGGACGTCCGTGCACAAG|CAGTATCGAAGCTATCACTTATTTGGTCGG
ACTTACAGGCGATAAAGAGTGGACGTCCGT|ATCGACCACGCTGTTGTCTTAGTCAAAACA
ATCGGTCTAAAAAATTAGCGGTATTAGCAG|TAAAGAGTGGACGTCCGTGCACAAGACAGT
GACAGTTAATAATCGACCACGCTGTTGTCT|CTTTACGGAGAAAGAGTGGACGTCCGTGCA
CGTGCACAAGACAGTATCGAGTGGAAGGCC|ACAGAGCACGCTTCAAAAGAACGCCATGGT
CAAGACAGTATTGCGTATTTGCGAAAGGGT|TTTGAGTGAGCAAGCACCCTTACATGAGGT
ACGTCCGTGCACAAGACAGTATGCACAAGA|CAAGAGCCGGGAGTCTCATAGTACTTACAG
AGCAGATACGACAAGAGTGGACGTCCGTAA|AGTATATGAGTCGTCTAAAATACCAATAAA
ATGTATACTTTATCTAAGTTATTGAGCAGA|AGAGTGGACGTCCGTGCACAAGACAGTATA
TGGAAACTTCAGGAAATTCGTGGCAGATTC|AGGGTAAGATAAAACGATAGCACGTTGACG
AGTGGACGTCCGTGCACAAGACAGTATAAA|GCTATCACTTATTTGGTCGGTTCGTAGGGA
TTAGTCAAAACAGAGCACGCTTCAAAAGAA|ACAAGACAGTATTGCGTATTTGCGAAAGGG
ACAAGACAGTATCGAAGCTATCACTTATTT|CAGTATACCTTCGCTCAGGGATGGCACAAA
AGAGCCGGGAGTCTCATAGTACTTACAGGC|ACTGGCAGTGACAGTTAATAATCGACCACG
ACCTGCGTCGCAGTAATCGTTTAAGAGTGG|ATGCACAAGACAGTATCGGTCTAAAAAATT
ACGTCCGTGCACAAGACAGTATCGAAGCTA|GTGCACAAGACAGTATACCTTCGCTCAGGG
CCGGGAGTCTCATAGTACTTACAGGCGATA|GCAGTGACAGTTAATAATCGACCACGCTGT
ATCACTTATTTGGTCGGTTCGTAGGGACAC|GATGGCACAAAGGTGCGTAGGGTTGACGAC
CAGTATGTATACTTTATCTAAGTTATTGAG|ACAAAGAGTGGACGTCCGTGCACAAGACAG
ACAAGACAGTATCGGTCTAAAAAATTAGCG|TTACAGGCGATAAAGAGTGGACGTCCGTGC
TACAGCCAGCCCGATATTTGCCCTTAACGC|GGTGACGGTAAAGACGTACCTGGAAACTTC
TCCCGCTACTTGACTTTACGGAGAAAGAGT|AGTATTACAGCCAGCCCGATATTTGCCCTT
GACAGTATGTATACTTTATCTAAGTTATTG|CCACAAAGAGTGGACGTCCGTGCACAAGAC
GTCCGTGCACAAGACAGTATGTCCGGTTAA|GTGCACAAGACAGTATCATGGCACGAAACT
CAGTATCACAAGACAGTATAGAGTGGACGT|AAGCTCCGACCTGCGTCGCAGTAATCGTTT
AAGACAGTATCATGGCACGAAACTCACGCG|ACGTCCGTGCACAAGACAGTATGTATACTT
TCAGGATTTTCTAGGTAAGAGTGGACGTCC|CGCAAATGAAAAGAGTGGACGTCCGTGCAC
GTGCACAAGACAGTATCATGGCACGAAACT|GAGTGGACGTCCGTGCACAAGACAGTATGT
ACGTCCGTGCACAAGACAGTATCACAAGAC|TATATAGCGAAGGAAAAAGCTCCGACCTGC
TATTGAGCAGATACGACAAGAGTGGACGTC|AAGACAGTATATGAGTCGTCTAAAATACCA
AAAGGGTAGGCTCGCTCGGTAGCTTGGCAG|ATGAGGTCATGCCACTGCGTGCCTCTTCGG
CCGTGCACAAGACAGTATAAATGGGTGACG|TATTTGGTCGGTTCGTAGGGACACCAGAGC
ACAGTATAGAGTGGACGTCCGTGCACAAGA|GCGTCGCAGTAATCGTTTAAGAGTGGACGT
AAGACAGTATAGAGTGGACGTCCGTGCACA|CCTGCGTCGCAGTAATCGTTTAAGAGTGGA
TTTACGGAGAAAGAGTGGACGTCCGTGCAC|CCCGATATTTGCCCTTAACGCACCTCTCCT
GACATACTTACAGCGTGCGTCCTGAGGACC|AGATACAGCGTAAGAGTGGACGTCCGTGCA
GGTCTAAAAGAGTGGACGTCCGTGCACAAG|CTATCGGAATGCCTAAAGAGTGGACGTCCG
CAGTATAAATGGGTGACGGTAAAGACGTAC|TCGTAGGGACACCAGAGCAATTCATGTAGC
CTGGTTGGGAGGTTATTCGTTAAGTTAAGG|TTGTCGACATACTTACAGCGTGCGTCCTGA
TTAAGGGCATTCTGTACAGGAACTGGCAGT|TCCTGAGGACCTATCGTTCCCGCTACTTGA
AGTATGCACAAGACAGTATCGGTCTAAAAA|ATAGTACTTACAGGCGATAAAGAGTGGACG
ACCTGGAAACTTCAGGAAATTCGTGGCAGA|GCAAGGGTAAGATAAAACGATAGCACGTTG
AGGTCTAAAAGAGTGGACGTCCGTGCACAA|TCTATCGGAATGCCTAAAGAGTGGACGTCC
ATAGTACTTACAGGCGATAAAGAGTGGACG|TAATAATCGACCACGCTGTTGTCTTAGTCA
CCTCTTCGGTCGAAAGAGTGGACGTCCGTG|ACAAGACAGTATCGAAGCTATCACTTATTT
GCATATATAGCGAAGGAAAAAGCTCCGACC|AGAGTGGACGTCCGTGCACAAGACAGTATG
CGTCCGTGCACAAGACAGTATGTATACTTT|GCGGTATTAGCAGCCACAAAGAGTGGACGT
GGACGTCCGTGCACAAGACAGTATAAATGG|ATCACTTATTTGGTCGGTTCGTAGGGACAC
AAACACATAACATCTATCGGAATGCCTAAA|TCACGCGTAGTTCCTACCCTGGGTAGCCTA
CCCGCTACTTGACTTTACGGAGAAAGAGTG|GTATTACAGCCAGCCCGATATTTGCCCTTA
GTGACGGTAAAGACGTACCTGGAAACTTCA|CAGAGCAATTCATGTAGCAAGGGTAAGATA
ACCCTGGGTAGCCTAAGTCGCTGGATGGAA|TTATTGAGCAGATACGACAAGAGTGGACGT
ACTGCGTGCCTCTTCGGTCGAAAGAGTGGA|GTCCGTGCACAAGACAGTATCGAAGCTATC
CTTCGGTCGAAAGAGTGGACGTCCGTGCAC|AGACAGTATCGAAGCTATCACTTATTTGGT
CGGAGAAAGAGTGGACGTCCGTGCACAAGA|ATATTTGCCCTTAACGCACCTCTCCTTTGA
CACAAGACAGTATATGAGTCGTCTAAAATA|GCTGGTTGGGAGGTTATTCGTTAAGTTAAG
AGTATAAATGGGTGACGGTAAAGACGTACC|CGTAGGGACACCAGAGCAATTCATGTAGCA
AAAAGAGTGGACGTCCGTGCACAAGACAGT|GGAATGCCTAAAGAGTGGACGTCCGTGAAG
TGAGTGAGCAAGCACCCTTACATGAGGTCA|TGGCAGATTCAGGATTTTCTAGGTAAGAGT
TGGGTAGCCTAAGTCGCTGGATGGAAGGGG|TGAGCAGATACGACAAGAGTGGACGTCCGT
CTGCGTCGCAGTAATCGTTTAAGAGTGGAC|GCACAAGACAGTATCGGTCTAAAAAATTAG
TCTAAAAGAGTGGACGTCCGTGCACAAGAC|ATCGGAATGCCTAAAGAGTGGACGTCCGTG
CTAAAAAATTAGCGGTATTAGCAGCCACAA|GTGGACGTCCGTGCACAAGACAGTATCGAG
ATACCAATAAAGCGCCACAAGAGCCGGGAG|AAGGGCATTCTGTACAGGAACTGGCAGTGA
GACGGCATCGGAACACTCGGAGTGGGACCA|GTCCGTGCACAAGACAGTATCACAAGACAG
GTATTACAGCCAGCCCGATATTTGCCCTTA|AATGGGTGACGGTAAAGACGTACCTGGAAA
AGACAGTATATGAGTCGTCTAAAATACCAA|GTTGGGAGGTTATTCGTTAAGTTAAGGGCA
GTATAGAGTGGACGTCCGTGCACAAGACAG|TCGCAGTAATCGTTTAAGAGTGGACGTCCG
AAATACCAATAAAGCGCCACAAGAGCCGGG|TTAAGGGCATTCTGTACAGGAACTGGCAGT
AAGGCCGACCTCCGCTGGTTGGGAGGTTAT|CATGGTATGTGCAGTTGTCGACATACTTAC
CAAGACAGTATGCACAAGACAGTATCGGTC|AGTCTCATAGTACTTACAGGCGATAAAGAG
GGTGACGGTAAAGACGTACCTGGAAACTTC|CCAGAGCAATTCATGTAGCAAGGGTAAGAT
GTGGACGTCCGTGCACAAGACAGTATCACA|GGCATATATAGCGAAGGAAAAAGCTCCGAC
AAGAGTGGACGTCCGTGCACAAGACAGTAT|AAAAAATTAGCGGTATTAGCAGCCACAAAG
AGGCGATAAAGAGTGGACGTCCGTGCACAA|CACGCTGTTGTCTTAGTCAAAACAGAGCAC
AAGACAGTATCACAAGACAGTATAGAGTGG|GAAAAAGCTCCGACCTGCGTCGCAGTAATC
CAGATACAGCGTAAGAGTGGACGTCCGTGC|CGGTCGAAAGAGTGGACGTCCGTGCACAAG
ACGCGTAGTTCCTACCCTGGGTAGCCTAAG|TACTTTATCTAAGTTATTGAGCAGATACGA
ATGCCTAAAGAGTGGACGTCCGTGAAGAGT|GGTAGCCTAAGTCGCTGGATGGAAGGGGGG
GGTAAGAGTGGACGTCCGTGCACAAGACAG|AGTGGACGTCCGTGCACAAGACAGTATACC
CATAGTACTTACAGGCGATAAAGAGTGGAC|TTAATAATCGACCACGCTGTTGTCTTAGTC
TTAACGCACCTCTCCTTTGAGTGAGCAAGC|AAACTTCAGGAAATTCGTGGCAGATTCAGG
GTGCAGTTGTCGACATACTTACAGCGTGCG|GGTAGCTTGGCAGATACAGCGTAAGAGTGG
GACGTCCGTGCACAAGACAGTATGTCCGGT|TCCGTGCACAAGACAGTATCATGGCACGAA
AAGACGTACCTGGAAACTTCAGGAAATTCG|TCATGTAGCAAGGGTAAGATAAAACGATAG
AGACAGTATTTCGTGACGGCATCGGAACAC|CGTGAAGAGTGGACGTCCGTGCACAAGACA
GTATTTCGTGACGGCATCGGAACACTCGGA|AGAGTGGACGTCCGTGCACAAGACAGTATC
ACATCTATCGGAATGCCTAAAGAGTGGACG|GTTCCTACCCTGGGTAGCCTAAGTCGCTGG
GTCCGTGCACAAGACAGTATTTCGTGACGG|GAGTGGACGTCCGTGAAGAGTGGACGTCCG
TATCGGAATGCCTAAAGAGTGGACGTCCGT|TACCCTGGGTAGCCTAAGTCGCTGGATGGA
AGAGTGGACGTCCGTGCACAAGACAGTATG|AAAAATTAGCGGTATTAGCAGCCACAAAGA
TATCGAGTGGAAGGCCGACCTCCGCTGGTT|AAAAGAACGCCATGGTATGTGCAGTTGTCG
AGTGAGCAAGCACCCTTACATGAGGTCATG|GCAGATTCAGGATTTTCTAGGTAAGAGTGG
GTTCCTACCCTGGGTAGCCTAAGTCGCTGG|TCTAAGTTATTGAGCAGATACGACAAGAGT
CGCCACAAGAGCCGGGAGTCTCATAGTACT|TACAGGAACTGGCAGTGACAGTTAATAATC
AAGTTATTGAGCAGATACGACAAGAGTGGA|GCACAAGACAGTATATGAGTCGTCTAAAAT
TTGCGTATTTGCGAAAGGGTAGGCTCGCTC|CAAGCACCCTTACATGAGGTCATGCCACTG
CGGTAAAGACGTACCTGGAAACTTCAGGAA|GCAATTCATGTAGCAAGGGTAAGATAAAAC
CGCGTAGTTCCTACCCTGGGTAGCCTAAGT|ACTTTATCTAAGTTATTGAGCAGATACGAC
GTCCGTGCACAAGACAGTATTACAGCCAGC|TGCACAAGACAGTATAAATGGGTGACGGTA
TTCCCGCTACTTGACTTTACGGAGAAAGAG|CAGTATTACAGCCAGCCCGATATTTGCCCT
TCCTGAGGACCTATCGTTCCCGCTACTTGA|ACGTCCGTGCACAAGACAGTATTACAGCCA
AAAGAGTGGACGTCCGTGCACAAGACAGTA|CGAAGCTATCACTTATTTGGTCGGTTCGTA
TGGATGGAAGGGGGGCATATATAGCGAAGG|AGTGGACGTCCGTAAGAGTGGACGTCCGTG
TCCGTGCACAAGACAGTATATGAGTCGTCT|ACCTCCGCTGGTTGGGAGGTTATTCGTTAA
GCATCGGAACACTCGGAGTGGGACCAAAGC|GTGCACAAGACAGTATCACAAGACAGTATA
GTTTAAGAGTGGACGTCCGTGCACAAGACA|GTCTAAAAAATTAGCGGTATTAGCAGCCAC
TATGTATACTTTATCTAAGTTATTGAGCAG|AAGAGTGGACGTCCGTGCACAAGACAGTAT
ATTTGCGAAAGGGTAGGCTCGCTCGGTAGC|CCCTTACATGAGGTCATGCCACTGCGTGCC
TTTGCGAAAGGGTAGGCTCGCTCGGTAGCT|CCTTACATGAGGTCATGCCACTGCGTGCCT
AAAGACGTACCTGGAAACTTCAGGAAATTC|TTCATGTAGCAAGGGTAAGATAAAACGATA
AGGGTAGGCTCGCTCGGTAGCTTGGCAGAT|GAGGTCATGCCACTGCGTGCCTCTTCGGTC
AGTGGACGTCCGTGCACAAGACAGTATTGC|CTTAACGCACCTCTCCTTTGAGTGAGCAAG
ACGTCCGTGCACAAGACAGTATCATGGCAC|GTTTAAGAGTGGACGTCCGTGCACAAGACA
AGCCTAAGTCGCTGGATGGAAGGGGGGCAT|AGATACGACAAGAGTGGACGTCCGTAAGAG
TGACGGCATCGGAACACTCGGAGTGGGACC|CGTCCGTGCACAAGACAGTATCACAAGACA
ACAGTATGTATACTTTATCTAAGTTATTGA|CACAAAGAGTGGACGTCCGTGCACAAGACA
GAGTGGACGTCCGTGCACAAGACAGTATTA|GACGTCCGTGCACAAGACAGTATAAATGGG
GTGGACGTCCGTGCACAAGACAGTATTTCG|CCTAAAGAGTGGACGTCCGTGAAGAGTGGA
TCCGCTGGTTGGGAGGTTATTCGTTAAGTT|GCAGTTGTCGACATACTTACAGCGTGCGTC
TATAAATGATCAGTCCACTGATACAATCCG|GTGGACGTCCGTGCACAAGACAGTATGTCC
TCACAAGACAGTATAGAGTGGACGTCCGTG|CCGACCTGCGTCGCAGTAATCGTTTAAGAG
AAAGAGTGGACGTCCGTGCACAAGACAGTA|TGCCCTTAACGCACCTCTCCTTTGAGTGAG
GTTCTCGCAAGGTCTAAAAGAGTGGACGTC|CACATAACATCTATCGGAATGCCTAAAGAG
AACACTGGCATAGCCTTATTCGAATATAAA|TCGGAGTGGGACCAAAGCGAAAGAGTGGAC
GGGTAGGCTCGCTCGGTAGCTTGGCAGATA|AGGTCATGCCACTGCGTGCCTCTTCGGTCG
TCCTACCCTGGGTAGCCTAAGTCGCTGGAT|TAAGTTATTGAGCAGATACGACAAGAGTGG
GTCGGTTCGTAGGGACACCAGAGCAATTCA|GTGCGTAGGGTTGACGACGTAAGGTTACTC
GACGTCCGTGCACAAGACAGTATGCACAAG|ACAAGAGCCGGGAGTCTCATAGTACTTACA
AGACGTACCTGGAAACTTCAGGAAATTCGT|CATGTAGCAAGGGTAAGATAAAACGATAGC
GGACGTCCGTGCACAAGACAGTATTGCGTA|AACGCACCTCTCCTTTGAGTGAGCAAGCAC
TATTGCGTATTTGCGAAAGGGTAGGCTCGC|AGCAAGCACCCTTACATGAGGTCATGCCAC
AGCTATCACTTATTTGGTCGGTTCGTAGGG|CAGGGATGGCACAAAGGTGCGTAGGGTTGA
CGGTAGCTTGGCAGATACAGCGTAAGAGTG|GCGTGCCTCTTCGGTCGAAAGAGTGGACGT
TAGCTTGGCAGATACAGCGTAAGAGTGGAC|TGCCTCTTCGGTCGAAAGAGTGGACGTCCG
CGTGCCTCTTCGGTCGAAAGAGTGGACGTC|GTGCACAAGACAGTATCGAAGCTATCACTT
CCGGTTAAAACACATAACATCTATCGGAAT|ACGAAACTCACGCGTAGTTCCTACCCTGGG
ACATACTTACAGCGTGCGTCCTGAGGACCT|GATACAGCGTAAGAGTGGACGTCCGTGCAC
CAAGACAGTATGTCCGGTTAAAACACATAA|ACAGTATCATGGCACGAAACTCACGCGTAG
CCACACTGTTCTCGCAAGGTCTAAAAGAGT|GTTAAAACACATAACATCTATCGGAATGCC
GTGCACAAGACAGTATCGAAGCTATCACTT|AAGACAGTATACCTTCGCTCAGGGATGGCA
GCTGGTTGGGAGGTTATTCGTTAAGTTAAG|GTTGTCGACATACTTACAGCGTGCGTCCTG
TCGTTTAAGAGTGGACGTCCGTGCACAAGA|CGGTCTAAAAAATTAGCGGTATTAGCAGCC
ACCAATAAAGCGCCACAAGAGCCGGGAGTC|GGGCATTCTGTACAGGAACTGGCAGTGACA
TCGTGACGGCATCGGAACACTCGGAGTGGG|GGACGTCCGTGCACAAGACAGTATCACAAG
ACGTCCGTGCACAAGACAGTATATGAGTCG|CCGACCTCCGCTGGTTGGGAGGTTATTCGT
TCCGTGCACAAGACAGTATCACAAGACAGT|ATAGCGAAGGAAAAAGCTCCGACCTGCGTC
CACAAGACAGTATGTATACTTTATCTAAGT|AGCAGCCACAAAGAGTGGACGTCCGTGCAC
CGAAAGAGTGGACGTCCGTGCACAAGACAG|AGAGTGGACGTCCGTGCACAAGACAGTATC
TCGCAAGGTCTAAAAGAGTGGACGTCCGTG|TAACATCTATCGGAATGCCTAAAGAGTGGA
CGTTCCCGCTACTTGACTTTACGGAGAAAG|GACAGTATTACAGCCAGCCCGATATTTGCC
AAGAGTGGACGTCCGTGCACAAGACAGTAT|GGACGTCCGTGCACAAGACAGTATACCTTC
TTTGGTCGGTTCGTAGGGACACCAGAGCAA|AAAGGTGCGTAGGGTTGACGACGTAAGGTT
AGTATCGAAGCTATCACTTATTTGGTCGGT|CCTTCGCTCAGGGATGGCACAAAGGTGCGT
TAGCCTAAGTCGCTGGATGGAAGGGGGGCA|CAGATACGACAAGAGTGGACGTCCGTAAGA
CAAGGTCTAAAAGAGTGGACGTCCGTGCAC|CATCTATCGGAATGCCTAAAGAGTGGACGT
GGTATTAGCAGCCACAAAGAGTGGACGTCC|CACAAGACAGTATCGAGTGGAAGGCCGACC
TGTCGACATACTTACAGCGTGCGTCCTGAG|TGGCAGATACAGCGTAAGAGTGGACGTCCG
TATATGAGTCGTCTAAAATACCAATAAAGC|AGGTTATTCGTTAAGTTAAGGGCATTCTGT
GGCATCGGAACACTCGGAGTGGGACCAAAG|CGTGCACAAGACAGTATCACAAGACAGTAT
ATGGTATGTGCAGTTGTCGACATACTTACA|CTCGCTCGGTAGCTTGGCAGATACAGCGTA
TACCTGGAAACTTCAGGAAATTCGTGGCAG|AGCAAGGGTAAGATAAAACGATAGCACGTT
TCCGTGCACAAGACAGTATCGAAGCTATCA|CACAAGACAGTATACCTTCGCTCAGGGATG
GCACAAGACAGTATCACAAGACAGTATAGA|GAAGGAAAAAGCTCCGACCTGCGTCGCAGT
AAAAAGCTCCGACCTGCGTCGCAGTAATCG|CACAAGACAGTATGCACAAGACAGTATCGG
TCTCCTTTGAGTGAGCAAGCACCCTTACAT|AAATTCGTGGCAGATTCAGGATTTTCTAGG
AGTATTTCGTGACGGCATCGGAACACTCGG|AAGAGTGGACGTCCGTGCACAAGACAGTAT
GTGCACAAGACAGTATTACAGCCAGCCCGA|CAAGACAGTATAAATGGGTGACGGTAAAGA
TAGAGTGGACGTCCGTGCACAAGACAGTAT|CAGTAATCGTTTAAGAGTGGACGTCCGTGC
GCTCGGTAGCTTGGCAGATACAGCGTAAGA|ACTGCGTGCCTCTTCGGTCGAAAGAGTGGA
GCTACTTGACTTTACGGAGAAAGAGTGGAC|TTACAGCCAGCCCGATATTTGCCCTTAACG
CAAGACAGTATCGAGTGGAAGGCCGACCTC|CACGCTTCAAAAGAACGCCATGGTATGTGC
CACGCGTAGTTCCTACCCTGGGTAGCCTAA|ATACTTTATCTAAGTTATTGAGCAGATACG
ACAAGAGTGGACGTCCGTAAGAGTGGACGT|TCGTCTAAAATACCAATAAAGCGCCACAAG
TTCTGTACAGGAACTGGCAGTGACAGTTAA|CCTATCGTTCCCGCTACTTGACTTTACGGA
CCAATAAAGCGCCACAAGAGCCGGGAGTCT|GGCATTCTGTACAGGAACTGGCAGTGACAG
GTGCACAAGACAGTATCACAAGACAGTATA|GCGAAGGAAAAAGCTCCGACCTGCGTCGCA
ACTCGGAGTGGGACCAAAGCGAAAGAGTGG|CAGTATCACAAGACAGTATAGAGTGGACGT
TGAGTCGTCTAAAATACCAATAAAGCGCCA|TATTCGTTAAGTTAAGGGCATTCTGTACAG
CAGAGCACGCTTCAAAAGAACGCCATGGTA|ATTGCGTATTTGCGAAAGGGTAGGCTCGCT
CGACATACTTACAGCGTGCGTCCTGAGGAC|CAGATACAGCGTAAGAGTGGACGTCCGTGC
TCCGTGCACAAGACAGTATTACAGCCAGCC|GCACAAGACAGTATAAATGGGTGACGGTAA
CACAAGACAGTATAGAGTGGACGTCCGTGC|CGACCTGCGTCGCAGTAATCGTTTAAGAGT
GCCACAAAGAGTGGACGTCCGTGCACAAGA|TATCGAGTGGAAGGCCGACCTCCGCTGGTT
TAAAGAGTGGACGTCCGTGCACAAGACAGT|GTTGTCTTAGTCAAAACAGAGCACGCTTCA
GAAGCTATCACTTATTTGGTCGGTTCGTAG|CTCAGGGATGGCACAAAGGTGCGTAGGGTT
GCGAAGGAAAAAGCTCCGACCTGCGTCGCA|GTCCGTGCACAAGACAGTATGCACAAGACA
CACATAACATCTATCGGAATGCCTAAAGAG|CGCGTAGTTCCTACCCTGGGTAGCCTAAGT
GGAACTGGCAGTGACAGTTAATAATCGACC|CCCGCTACTTGACTTTACGGAGAAAGAGTG
TGACTTTACGGAGAAAGAGTGGACGTCCGT|CCAGCCCGATATTTGCCCTTAACGCACCTC
GCACAAGACAGTATTGCGTATTTGCGAAAG|TCCTTTGAGTGAGCAAGCACCCTTACATGA
ACAAGACAGTATATGAGTCGTCTAAAATAC|CTGGTTGGGAGGTTATTCGTTAAGTTAAGG
GGCATTCTGTACAGGAACTGGCAGTGACAG|AGGACCTATCGTTCCCGCTACTTGACTTTA
AAACTTCAGGAAATTCGTGGCAGATTCAGG|GTAAGATAAAACGATAGCACGTTGACGCAA
TATGTGCAGTTGTCGACATACTTACAGCGT|CTCGGTAGCTTGGCAGATACAGCGTAAGAG
ACAGTATATGAGTCGTCTAAAATACCAATA|TGGGAGGTTATTCGTTAAGTTAAGGGCATT
ATGCACAAGACAGTATCGGTCTAAAAAATT|GTACTTACAGGCGATAAAGAGTGGACGTCC
TCTGTACAGGAACTGGCAGTGACAGTTAAT|CTATCGTTCCCGCTACTTGACTTTACGGAG
TACCAATAAAGCGCCACAAGAGCCGGGAGT|AGGGCATTCTGTACAGGAACTGGCAGTGAC
GATACGACAAGAGTGGACGTCCGTAAGAGT|TATGAGTCGTCTAAAATACCAATAAAGCGC
ACAGTATGCACAAGACAGTATCGGTCTAAA|TCATAGTACTTACAGGCGATAAAGAGTGGA
CGTATTTGCGAAAGGGTAGGCTCGCTCGGT|GCACCCTTACATGAGGTCATGCCACTGCGT
ACAGCCAGCCCGATATTTGCCCTTAACGCA|GTGACGGTAAAGACGTACCTGGAAACTTCA
AGCACGCTTCAAAAGAACGCCATGGTATGT|GCGTATTTGCGAAAGGGTAGGCTCGCTCGG
CCTTATTCGAATATAAATGATCAGTCCACT|AAAGCGAAAGAGTGGACGTCCGTGCACAAG
GTTGGGAGGTTATTCGTTAAGTTAAGGGCA|TCGACATACTTACAGCGTGCGTCCTGAGGA
AATCGACCACGCTGTTGTCTTAGTCAAAAC|AAAGAGTGGACGTCCGTGCACAAGACAGTA
ACAATCCGGCCACACTGTTCTCGCAAGGTC|GTATGTCCGGTTAAAACACATAACATCTAT
TACCCTGGGTAGCCTAAGTCGCTGGATGGA|GTTATTGAGCAGATACGACAAGAGTGGACG
CCCTTACATGAGGTCATGCCACTGCGTGCC|TTTTCTAGGTAAGAGTGGACGTCCGTGCAC
CACAAGACAGTATTGCGTATTTGCGAAAGG|CCTTTGAGTGAGCAAGCACCCTTACATGAG
CGTTAAGTTAAGGGCATTCTGTACAGGAAC|GCGTGCGTCCTGAGGACCTATCGTTCCCGC
AATACCAATAAAGCGCCACAAGAGCCGGGA|TAAGGGCATTCTGTACAGGAACTGGCAGTG
TCCGTGCACAAGACAGTATGTATACTTTAT|GGTATTAGCAGCCACAAAGAGTGGACGTCC
TACGACAAGAGTGGACGTCCGTAAGAGTGG|TGAGTCGTCTAAAATACCAATAAAGCGCCA
GGAGTGGGACCAAAGCGAAAGAGTGGACGT|ATCACAAGACAGTATAGAGTGGACGTCCGT
CGGTATTAGCAGCCACAAAGAGTGGACGTC|GCACAAGACAGTATCGAGTGGAAGGCCGAC
CAGTTAATAATCGACCACGCTGTTGTCTTA|TTACGGAGAAAGAGTGGACGTCCGTGCACA
CGTCCGTGCACAAGACAGTATCGAGTGGAA|CAAAACAGAGCACGCTTCAAAAGAACGCCA
GCTGGATGGAAGGGGGGCATATATAGCGAA|AGAGTGGACGTCCGTAAGAGTGGACGTCCG
ATAGAGTGGACGTCCGTGCACAAGACAGTA|GCAGTAATCGTTTAAGAGTGGACGTCCGTG
CTTAACGCACCTCTCCTTTGAGTGAGCAAG|GAAACTTCAGGAAATTCGTGGCAGATTCAG
CATGAGGTCATGCCACTGCGTGCCTCTTCG|AGGTAAGAGTGGACGTCCGTGCACAAGACA
CGTGCACAAGACAGTATTTCGTGACGGCAT|TGGACGTCCGTGAAGAGTGGACGTCCGTGC
TATTTGCGAAAGGGTAGGCTCGCTCGGTAG|ACCCTTACATGAGGTCATGCCACTGCGTGC
ATGGCACGAAACTCACGCGTAGTTCCTACC|CAAGACAGTATGTATACTTTATCTAAGTTA
AAATTAGCGGTATTAGCAGCCACAAAGAGT|CGTCCGTGCACAAGACAGTATCGAGTGGAA
CGTTTAAGAGTGGACGTCCGTGCACAAGAC|GGTCTAAAAAATTAGCGGTATTAGCAGCCA
CGTCCGTGCACAAGACAGTATTTCGTGACG|AGAGTGGACGTCCGTGAAGAGTGGACGTCC
TAACATCTATCGGAATGCCTAAAGAGTGGA|TAGTTCCTACCCTGGGTAGCCTAAGTCGCT
GCACCTCTCCTTTGAGTGAGCAAGCACCCT|TCAGGAAATTCGTGGCAGATTCAGGATTTT
AAGAGTGGACGTCCGTGCACAAGACAGTAT|GTGGAAGGCCGACCTCCGCTGGTTGGGAGG
CATGCCACTGCGTGCCTCTTCGGTCGAAAG|GTGGACGTCCGTGCACAAGACAGTATCGAA
AAGACAGTATCGAGTGGAAGGCCGACCTCC|ACGCTTCAAAAGAACGCCATGGTATGTGCA
GAGTGGACGTCCGTGCACAAGACAGTATTT|TGCCTAAAGAGTGGACGTCCGTGAAGAGTG
AGTTAATAATCGACCACGCTGTTGTCTTAG|TACGGAGAAAGAGTGGACGTCCGTGCACAA
TAGCCTTATTCGAATATAAATGATCAGTCC|ACCAAAGCGAAAGAGTGGACGTCCGTGCAC
GAACGCCATGGTATGTGCAGTTGTCGACAT|GGGTAGGCTCGCTCGGTAGCTTGGCAGATA
TGGACGTCCGTGAAGAGTGGACGTCCGTGC|CGCTGGATGGAAGGGGGGCATATATAGCGA
TTTGAGTGAGCAAGCACCCTTACATGAGGT|CGTGGCAGATTCAGGATTTTCTAGGTAAGA
ACAAAGAGTGGACGTCCGTGCACAAGACAG|CGAGTGGAAGGCCGACCTCCGCTGGTTGGG
TAATCGACCACGCTGTTGTCTTAGTCAAAA|GAAAGAGTGGACGTCCGTGCACAAGACAGT
GCGCCACAAGAGCCGGGAGTCTCATAGTAC|GTACAGGAACTGGCAGTGACAGTTAATAAT
CTCGCTCGGTAGCTTGGCAGATACAGCGTA|GCCACTGCGTGCCTCTTCGGTCGAAAGAGT
GACAGTATTACAGCCAGCCCGATATTTGCC|TATAAATGGGTGACGGTAAAGACGTACCTG
ACAGTATTACAGCCAGCCCGATATTTGCCC|ATAAATGGGTGACGGTAAAGACGTACCTGG
CGTCTAAAATACCAATAAAGCGCCACAAGA|GTTAAGTTAAGGGCATTCTGTACAGGAACT
TTCGTTAAGTTAAGGGCATTCTGTACAGGA|CAGCGTGCGTCCTGAGGACCTATCGTTCCC
ATTCGTGGCAGATTCAGGATTTTCTAGGTA|GATAGCACGTTGACGCAAATGAAAAGAGTG
TGCCCTTAACGCACCTCTCCTTTGAGTGAG|CCTGGAAACTTCAGGAAATTCGTGGCAGAT
TTCGTGGCAGATTCAGGATTTTCTAGGTAA|ATAGCACGTTGACGCAAATGAAAAGAGTGG
AGAGTGGACGTCCGTGCACAAGACAGTATG|TGGACGTCCGTGCACAAGACAGTATCATGG
CGTGGCAGATTCAGGATTTTCTAGGTAAGA|AGCACGTTGACGCAAATGAAAAGAGTGGAC
GGAAACTTCAGGAAATTCGTGGCAGATTCA|GGGTAAGATAAAACGATAGCACGTTGACGC
TACTTACAGGCGATAAAGAGTGGACGTCCG|AATCGACCACGCTGTTGTCTTAGTCAAAAC
ACTTCAGGAAATTCGTGGCAGATTCAGGAT|AAGATAAAACGATAGCACGTTGACGCAAAT
TCGTTCCCGCTACTTGACTTTACGGAGAAA|AGACAGTATTACAGCCAGCCCGATATTTGC
ATCGACCACGCTGTTGTCTTAGTCAAAACA|AAGAGTGGACGTCCGTGCACAAGACAGTAT
GCTGTTGTCTTAGTCAAAACAGAGCACGCT|CGTCCGTGCACAAGACAGTATTGCGTATTT
GTCGACATACTTACAGCGTGCGTCCTGAGG|GGCAGATACAGCGTAAGAGTGGACGTCCGT
AGATACGACAAGAGTGGACGTCCGTAAGAG|ATATGAGTCGTCTAAAATACCAATAAAGCG
TGCACAAGACAGTATCGAGTGGAAGGCCGA|AGAGCACGCTTCAAAAGAACGCCATGGTAT
ACAGTATTTCGTGACGGCATCGGAACACTC|TGAAGAGTGGACGTCCGTGCACAAGACAGT
GAGTGGACGTCCGTGCACAAGACAGTATGT|AAAATTAGCGGTATTAGCAGCCACAAAGAG
GGTCTAAAAAATTAGCGGTATTAGCAGCCA|AGAGTGGACGTCCGTGCACAAGACAGTATC
CGGTTAAAACACATAACATCTATCGGAATG|CGAAACTCACGCGTAGTTCCTACCCTGGGT
GTGCACAAGACAGTATCGAGTGGAAGGCCG|CAGAGCACGCTTCAAAAGAACGCCATGGTA
TACGGAGAAAGAGTGGACGTCCGTGCACAA|CGATATTTGCCCTTAACGCACCTCTCCTTT
TTGGCAGATACAGCGTAAGAGTGGACGTCC|TCTTCGGTCGAAAGAGTGGACGTCCGTGCA
AGTGGAAGGCCGACCTCCGCTGGTTGGGAG|AACGCCATGGTATGTGCAGTTGTCGACATA
GCGTATTTGCGAAAGGGTAGGCTCGCTCGG|AGCACCCTTACATGAGGTCATGCCACTGCG
CAGTATCGAGTGGAAGGCCGACCTCCGCTG|TTCAAAAGAACGCCATGGTATGTGCAGTTG
GGACCAAAGCGAAAGAGTGGACGTCCGTGC|AGACAGTATAGAGTGGACGTCCGTGCACAA
TATCGGTCTAAAAAATTAGCGGTATTAGCA|ATAAAGAGTGGACGTCCGTGCACAAGACAG
TATCATGGCACGAAACTCACGCGTAGTTCC|TGCACAAGACAGTATGTATACTTTATCTAA
TAAAAAATTAGCGGTATTAGCAGCCACAAA|TGGACGTCCGTGCACAAGACAGTATCGAGT
ATTTGGTCGGTTCGTAGGGACACCAGAGCA|CAAAGGTGCGTAGGGTTGACGACGTAAGGT
CTCTTCGGTCGAAAGAGTGGACGTCCGTGC|CAAGACAGTATCGAAGCTATCACTTATTTG
TAAGAGTGGACGTCCGTGCACAAGACAGTA|TAAAAAATTAGCGGTATTAGCAGCCACAAA
GAGTGGACGTCCGTGCACAAGACAGTATCG|ACGTCCGTGCACAAGACAGTATACCTTCGC
TGAACACTGGCATAGCCTTATTCGAATATA|ACTCGGAGTGGGACCAAAGCGAAAGAGTGG
TGCGTCGCAGTAATCGTTTAAGAGTGGACG|CACAAGACAGTATCGGTCTAAAAAATTAGC
GACGTCCGTGCACAAGACAGTATTACAGCC|CCGTGCACAAGACAGTATAAATGGGTGACG
TGGGACCAAAGCGAAAGAGTGGACGTCCGT|CAAGACAGTATAGAGTGGACGTCCGTGCAC
CGCTCGGTAGCTTGGCAGATACAGCGTAAG|CACTGCGTGCCTCTTCGGTCGAAAGAGTGG
AGGAACTGGCAGTGACAGTTAATAATCGAC|TCCCGCTACTTGACTTTACGGAGAAAGAGT
CTGTTGTCTTAGTCAAAACAGAGCACGCTT|GTCCGTGCACAAGACAGTATTGCGTATTTG
CACAAGACAGTATTTCGTGACGGCATCGGA|CGTCCGTGAAGAGTGGACGTCCGTGCACAA
ACAGTATCGAAGCTATCACTTATTTGGTCG|TACCTTCGCTCAGGGATGGCACAAAGGTGC
TGAAGAGTGGACGTCCGTGCACAAGACAGT|AAGGGGGGCATATATAGCGAAGGAAAAAGC
GGCACGAAACTCACGCGTAGTTCCTACCCT|AGACAGTATGTATACTTTATCTAAGTTATT
GGAAATTCGTGGCAGATTCAGGATTTTCTA|AAACGATAGCACGTTGACGCAAATGAAAAG
CACAAGACAGTATGCACAAGACAGTATCGG|GGAGTCTCATAGTACTTACAGGCGATAAAG
CGTCCGTGCACAAGACAGTATCACAAGACA|ATATAGCGAAGGAAAAAGCTCCGACCTGCG
AGTGGACGTCCGTGCACAAGACAGTATCAC|GGGCATATATAGCGAAGGAAAAAGCTCCGA
TTTCTAGGTAAGAGTGGACGTCCGTGCACA|GAAAAGAGTGGACGTCCGTGCACAAGACAG
CGTCCGTAAGAGTGGACGTCCGTGCACAAG|ACCAATAAAGCGCCACAAGAGCCGGGAGTC
CAGATTCAGGATTTTCTAGGTAAGAGTGGA|GTTGACGCAAATGAAAAGAGTGGACGTCCG
ACGAAACTCACGCGTAGTTCCTACCCTGGG|CAGTATGTATACTTTATCTAAGTTATTGAG
CTCGGAGTGGGACCAAAGCGAAAGAGTGGA|AGTATCACAAGACAGTATAGAGTGGACGTC
AGCCGGGAGTCTCATAGTACTTACAGGCGA|TGGCAGTGACAGTTAATAATCGACCACGCT
ACCTCTCCTTTGAGTGAGCAAGCACCCTTA|AGGAAATTCGTGGCAGATTCAGGATTTTCT
CAGATACGACAAGAGTGGACGTCCGTAAGA|TATATGAGTCGTCTAAAATACCAATAAAGC
GCGATAAAGAGTGGACGTCCGTGCACAAGA|CGCTGTTGTCTTAGTCAAAACAGAGCACGC
TTCAAAAGAACGCCATGGTATGTGCAGTTG|TGCGAAAGGGTAGGCTCGCTCGGTAGCTTG
CTTTACGGAGAAAGAGTGGACGTCCGTGCA|GCCCGATATTTGCCCTTAACGCACCTCTCC
GACCACGCTGTTGTCTTAGTCAAAACAGAG|AGTGGACGTCCGTGCACAAGACAGTATTGC
CCGTGCACAAGACAGTATTACAGCCAGCCC|CACAAGACAGTATAAATGGGTGACGGTAAA
TAAAGCGCCACAAGAGCCGGGAGTCTCATA|TTCTGTACAGGAACTGGCAGTGACAGTTAA
CTGGCATAGCCTTATTCGAATATAAATGAT|AGTGGGACCAAAGCGAAAGAGTGGACGTCC
AAGAACGCCATGGTATGTGCAGTTGTCGAC|AAGGGTAGGCTCGCTCGGTAGCTTGGCAGA
AGTCGCTGGATGGAAGGGGGGCATATATAG|GACAAGAGTGGACGTCCGTAAGAGTGGACG
CAGTATCATGGCACGAAACTCACGCGTAGT|CCGTGCACAAGACAGTATGTATACTTTATC
AGTATCGAGTGGAAGGCCGACCTCCGCTGG|TCAAAAGAACGCCATGGTATGTGCAGTTGT
AGCTTGGCAGATACAGCGTAAGAGTGGACG|GCCTCTTCGGTCGAAAGAGTGGACGTCCGT
CACAAGACAGTATCGAGTGGAAGGCCGACC|AGCACGCTTCAAAAGAACGCCATGGTATGT
TCCGTAAGAGTGGACGTCCGTGCACAAGAC|CAATAAAGCGCCACAAGAGCCGGGAGTCTC
GAAGGGGGGCATATATAGCGAAGGAAAAAG|CGTCCGTAAGAGTGGACGTCCGTGCACAAG
TGCAGTTGTCGACATACTTACAGCGTGCGT|GTAGCTTGGCAGATACAGCGTAAGAGTGGA
AAGGGCATTCTGTACAGGAACTGGCAGTGA|CTGAGGACCTATCGTTCCCGCTACTTGACT
GCCTAAAGAGTGGACGTCCGTGAAGAGTGG|TAGCCTAAGTCGCTGGATGGAAGGGGGGCA
CGCAAGGTCTAAAAGAGTGGACGTCCGTGC|AACATCTATCGGAATGCCTAAAGAGTGGAC
CAGTATTGCGTATTTGCGAAAGGGTAGGCT|GTGAGCAAGCACCCTTACATGAGGTCATGC
GCGTAGTTCCTACCCTGGGTAGCCTAAGTC|CTTTATCTAAGTTATTGAGCAGATACGACA
GACGTCCGTGCACAAGACAGTATTTCGTGA|AAAGAGTGGACGTCCGTGAAGAGTGGACGT
TCGGAGTGGGACCAAAGCGAAAGAGTGGAC|GTATCACAAGACAGTATAGAGTGGACGTCC
GGTCGGTTCGTAGGGACACCAGAGCAATTC|GGTGCGTAGGGTTGACGACGTAAGGTTACT
GAGTGGACGTCCGTGCACAAGACAGTATGC|GCGCCACAAGAGCCGGGAGTCTCATAGTAC
TGCACAAGACAGTATGCACAAGACAGTATC|CGGGAGTCTCATAGTACTTACAGGCGATAA
TTAGCGGTATTAGCAGCCACAAAGAGTGGA|CCGTGCACAAGACAGTATCGAGTGGAAGGC
CGAAAGGGTAGGCTCGCTCGGTAGCTTGGC|ACATGAGGTCATGCCACTGCGTGCCTCTTC
AGCTCCGACCTGCGTCGCAGTAATCGTTTA|AGACAGTATGCACAAGACAGTATCGGTCTA
CAGTATTTCGTGACGGCATCGGAACACTCG|GAAGAGTGGACGTCCGTGCACAAGACAGTA
CCAGCCCGATATTTGCCCTTAACGCACCTC|CGGTAAAGACGTACCTGGAAACTTCAGGAA
AAGTCGCTGGATGGAAGGGGGGCATATATA|CGACAAGAGTGGACGTCCGTAAGAGTGGAC
CGCCATGGTATGTGCAGTTGTCGACATACT|TAGGCTCGCTCGGTAGCTTGGCAGATACAG
CTCACGCGTAGTTCCTACCCTGGGTAGCCT|GTATACTTTATCTAAGTTATTGAGCAGATA
GTCCACTGATACAATCCGGCCACACTGTTC|GCACAAGACAGTATGTCCGGTTAAAACACA
AGTACTTACAGGCGATAAAGAGTGGACGTC|ATAATCGACCACGCTGTTGTCTTAGTCAAA
GGCCGACCTCCGCTGGTTGGGAGGTTATTC|TGGTATGTGCAGTTGTCGACATACTTACAG
GTGCACAAGACAGTATTTCGTGACGGCATC|GGACGTCCGTGAAGAGTGGACGTCCGTGCA
CTGTTCTCGCAAGGTCTAAAAGAGTGGACG|AACACATAACATCTATCGGAATGCCTAAAG
GTCATGCCACTGCGTGCCTCTTCGGTCGAA|GAGTGGACGTCCGTGCACAAGACAGTATCG
TCCGTGCACAAGACAGTATTGCGTATTTGC|ACCTCTCCTTTGAGTGAGCAAGCACCCTTA
CGTGCGTCCTGAGGACCTATCGTTCCCGCT|GAGTGGACGTCCGTGCACAAGACAGTATTA
AGTCTCATAGTACTTACAGGCGATAAAGAG|GACAGTTAATAATCGACCACGCTGTTGTCT
CAAGAGTGGACGTCCGTAAGAGTGGACGTC|CGTCTAAAATACCAATAAAGCGCCACAAGA
GCACAAGACAGTATGTATACTTTATCTAAG|TAGCAGCCACAAAGAGTGGACGTCCGTGCA
CGGTTCGTAGGGACACCAGAGCAATTCATG|GCGTAGGGTTGACGACGTAAGGTTACTCCT
GCATAGCCTTATTCGAATATAAATGATCAG|GGGACCAAAGCGAAAGAGTGGACGTCCGTG
GTGCCTCTTCGGTCGAAAGAGTGGACGTCC|TGCACAAGACAGTATCGAAGCTATCACTTA
AAAGCTCCGACCTGCGTCGCAGTAATCGTT|CAAGACAGTATGCACAAGACAGTATCGGTC
GCCCGATATTTGCCCTTAACGCACCTCTCC|TAAAGACGTACCTGGAAACTTCAGGAAATT
GATATTTGCCCTTAACGCACCTCTCCTTTG|GACGTACCTGGAAACTTCAGGAAATTCGTG
CGCTGGATGGAAGGGGGGCATATATAGCGA|AAGAGTGGACGTCCGTAAGAGTGGACGTCC
TAGGTAAGAGTGGACGTCCGTGCACAAGAC|AGAGTGGACGTCCGTGCACAAGACAGTATA
TCTAGGTAAGAGTGGACGTCCGTGCACAAG|AAAGAGTGGACGTCCGTGCACAAGACAGTA
CAGCCCGATATTTGCCCTTAACGCACCTCT|GGTAAAGACGTACCTGGAAACTTCAGGAAA
CCCTGGGTAGCCTAAGTCGCTGGATGGAAG|TATTGAGCAGATACGACAAGAGTGGACGTC
ATCCGGCCACACTGTTCTCGCAAGGTCTAA|TGTCCGGTTAAAACACATAACATCTATCGG
ATAACATCTATCGGAATGCCTAAAGAGTGG|GTAGTTCCTACCCTGGGTAGCCTAAGTCGC
GTATCGAGTGGAAGGCCGACCTCCGCTGGT|CAAAAGAACGCCATGGTATGTGCAGTTGTC
ATTGCGTATTTGCGAAAGGGTAGGCTCGCT|GCAAGCACCCTTACATGAGGTCATGCCACT
AAGACAGTATTGCGTATTTGCGAAAGGGTA|TTGAGTGAGCAAGCACCCTTACATGAGGTC
GCTCGCTCGGTAGCTTGGCAGATACAGCGT|TGCCACTGCGTGCCTCTTCGGTCGAAAGAG
TACATGAGGTCATGCCACTGCGTGCCTCTT|CTAGGTAAGAGTGGACGTCCGTGCACAAGA
CCTGGAAACTTCAGGAAATTCGTGGCAGAT|CAAGGGTAAGATAAAACGATAGCACGTTGA
ACTTACAGCGTGCGTCCTGAGGACCTATCG|CAGCGTAAGAGTGGACGTCCGTGCACAAGA
AGAGTGGACGTCCGTGAAGAGTGGACGTCC|AAGTCGCTGGATGGAAGGGGGGCATATATA
GAATGCCTAAAGAGTGGACGTCCGTGAAGA|TGGGTAGCCTAAGTCGCTGGATGGAAGGGG
TAGCGGTATTAGCAGCCACAAAGAGTGGAC|CGTGCACAAGACAGTATCGAGTGGAAGGCC
TGAGCAGATACGACAAGAGTGGACGTCCGT|ACAGTATATGAGTCGTCTAAAATACCAATA
GTGGACGTCCGTGCACAAGACAGTATTGCG|TTAACGCACCTCTCCTTTGAGTGAGCAAGC
GTGAAGAGTGGACGTCCGTGCACAAGACAG|GAAGGGGGGCATATATAGCGAAGGAAAAAG
GGAGTCTCATAGTACTTACAGGCGATAAAG|GTGACAGTTAATAATCGACCACGCTGTTGT
GGGCATATATAGCGAAGGAAAAAGCTCCGA|TAAGAGTGGACGTCCGTGCACAAGACAGTA
AGATACAGCGTAAGAGTGGACGTCCGTGCA|GGTCGAAAGAGTGGACGTCCGTGCACAAGA
CGTCCGTGCACAAGACAGTATAAATGGGTG|ACTTATTTGGTCGGTTCGTAGGGACACCAG
ACAGTATTGCGTATTTGCGAAAGGGTAGGC|AGTGAGCAAGCACCCTTACATGAGGTCATG
AGTGGACGTCCGTGCACAAGACAGTATCGA|CTTAGTCAAAACAGAGCACGCTTCAAAAGA
TGCGTATTTGCGAAAGGGTAGGCTCGCTCG|AAGCACCCTTACATGAGGTCATGCCACTGC
GTCCTGAGGACCTATCGTTCCCGCTACTTG|GACGTCCGTGCACAAGACAGTATTACAGCC
CTTACATGAGGTCATGCCACTGCGTGCCTC|TTCTAGGTAAGAGTGGACGTCCGTGCACAA
AGCGGTATTAGCAGCCACAAAGAGTGGACG|GTGCACAAGACAGTATCGAGTGGAAGGCCG
CGTCCGTGCACAAGACAGTATATGAGTCGT|CGACCTCCGCTGGTTGGGAGGTTATTCGTT
TCGCTGGATGGAAGGGGGGCATATATAGCG|CAAGAGTGGACGTCCGTAAGAGTGGACGTC
CTTAGTCAAAACAGAGCACGCTTCAAAAGA|CACAAGACAGTATTGCGTATTTGCGAAAGG
GTGGACGTCCGTGCACAAGACAGTATGCAC|GCCACAAGAGCCGGGAGTCTCATAGTACTT
GATACAGCGTAAGAGTGGACGTCCGTGCAC|GTCGAAAGAGTGGACGTCCGTGCACAAGAC
GCGAAAGAGTGGACGTCCGTGCACAAGACA|TAGAGTGGACGTCCGTGCACAAGACAGTAT
ATTACAGCCAGCCCGATATTTGCCCTTAAC|TGGGTGACGGTAAAGACGTACCTGGAAACT
CCCTTAACGCACCTCTCCTTTGAGTGAGCA|TGGAAACTTCAGGAAATTCGTGGCAGATTC
GTAATCGTTTAAGAGTGGACGTCCGTGCAC|GTATCGGTCTAAAAAATTAGCGGTATTAGC
TTACATGAGGTCATGCCACTGCGTGCCTCT|TCTAGGTAAGAGTGGACGTCCGTGCACAAG
CAGTAATCGTTTAAGAGTGGACGTCCGTGC|CAGTATCGGTCTAAAAAATTAGCGGTATTA
CGAAGGAAAAAGCTCCGACCTGCGTCGCAG|TCCGTGCACAAGACAGTATGCACAAGACAG
GACAGTATTGCGTATTTGCGAAAGGGTAGG|GAGTGAGCAAGCACCCTTACATGAGGTCAT
TGGACGTCCGTGCACAAGACAGTATTGCGT|TAACGCACCTCTCCTTTGAGTGAGCAAGCA
AAAATACCAATAAAGCGCCACAAGAGCCGG|GTTAAGGGCATTCTGTACAGGAACTGGCAG
TCTAAGTTATTGAGCAGATACGACAAGAGT|CGTGCACAAGACAGTATATGAGTCGTCTAA
GCCGGGAGTCTCATAGTACTTACAGGCGAT|GGCAGTGACAGTTAATAATCGACCACGCTG
AAATTCGTGGCAGATTCAGGATTTTCTAGG|ACGATAGCACGTTGACGCAAATGAAAAGAG
GTCCGTGCACAAGACAGTATATGAGTCGTC|GACCTCCGCTGGTTGGGAGGTTATTCGTTA
GGACGTCCGTGCACAAGACAGTATGTCCGG|GTCCGTGCACAAGACAGTATCATGGCACGA
TGCACAAGACAGTATTACAGCCAGCCCGAT|AAGACAGTATAAATGGGTGACGGTAAAGAC
AACATCTATCGGAATGCCTAAAGAGTGGAC|AGTTCCTACCCTGGGTAGCCTAAGTCGCTG
ACAGTATAAATGGGTGACGGTAAAGACGTA|TTCGTAGGGACACCAGAGCAATTCATGTAG
TTACAGCGTGCGTCCTGAGGACCTATCGTT|GCGTAAGAGTGGACGTCCGTGCACAAGACA
TTCCTACCCTGGGTAGCCTAAGTCGCTGGA|CTAAGTTATTGAGCAGATACGACAAGAGTG
GAAAGAGTGGACGTCCGTGCACAAGACAGT|TTGCCCTTAACGCACCTCTCCTTTGAGTGA
ATTCGAATATAAATGATCAGTCCACTGATA|CGAAAGAGTGGACGTCCGTGCACAAGACAG
TTTCGTGACGGCATCGGAACACTCGGAGTG|GTGGACGTCCGTGCACAAGACAGTATCACA
CGTGCACAAGACAGTATCGAAGCTATCACT|CAAGACAGTATACCTTCGCTCAGGGATGGC
TTACAGCCAGCCCGATATTTGCCCTTAACG|GGGTGACGGTAAAGACGTACCTGGAAACTT
ATTGAGCAGATACGACAAGAGTGGACGTCC|AGACAGTATATGAGTCGTCTAAAATACCAA
ATTCTGTACAGGAACTGGCAGTGACAGTTA|ACCTATCGTTCCCGCTACTTGACTTTACGG
TCCGTGCACAAGACAGTATTTCGTGACGGC|AGTGGACGTCCGTGAAGAGTGGACGTCCGT
GGACGTCCGTGCACAAGACAGTATTACAGC|TCCGTGCACAAGACAGTATAAATGGGTGAC
TAAAAGAGTGGACGTCCGTGCACAAGACAG|CGGAATGCCTAAAGAGTGGACGTCCGTGAA
AGTTCCTACCCTGGGTAGCCTAAGTCGCTG|ATCTAAGTTATTGAGCAGATACGACAAGAG
ACGCTTCAAAAGAACGCCATGGTATGTGCA|TATTTGCGAAAGGGTAGGCTCGCTCGGTAG
ACAGTATCACAAGACAGTATAGAGTGGACG|AAAGCTCCGACCTGCGTCGCAGTAATCGTT
GTGCACAAGACAGTATATGAGTCGTCTAAA|TCCGCTGGTTGGGAGGTTATTCGTTAAGTT
ATCTAAGTTATTGAGCAGATACGACAAGAG|CCGTGCACAAGACAGTATATGAGTCGTCTA
CTACCCTGGGTAGCCTAAGTCGCTGGATGG|AGTTATTGAGCAGATACGACAAGAGTGGAC
GTAAGAGTGGACGTCCGTGCACAAGACAGT|GTGGACGTCCGTGCACAAGACAGTATACCT
GGCGATAAAGAGTGGACGTCCGTGCACAAG|ACGCTGTTGTCTTAGTCAAAACAGAGCACG
GACAGTATCGGTCTAAAAAATTAGCGGTAT|AGGCGATAAAGAGTGGACGTCCGTGCACAA
TGTGCAGTTGTCGACATACTTACAGCGTGC|CGGTAGCTTGGCAGATACAGCGTAAGAGTG
ACACTGGCATAGCCTTATTCGAATATAAAT|CGGAGTGGGACCAAAGCGAAAGAGTGGACG
GGGACCAAAGCGAAAGAGTGGACGTCCGTG|AAGACAGTATAGAGTGGACGTCCGTGCACA
TATACTTTATCTAAGTTATTGAGCAGATAC|GTGGACGTCCGTGCACAAGACAGTATATGA
TTGTCGACATACTTACAGCGTGCGTCCTGA|TTGGCAGATACAGCGTAAGAGTGGACGTCC
GGGTGACGGTAAAGACGTACCTGGAAACTT|ACCAGAGCAATTCATGTAGCAAGGGTAAGA
GTTCCCGCTACTTGACTTTACGGAGAAAGA|ACAGTATTACAGCCAGCCCGATATTTGCCC
ACAAGACAGTATTTCGTGACGGCATCGGAA|GTCCGTGAAGAGTGGACGTCCGTGCACAAG
GGTCGAAAGAGTGGACGTCCGTGCACAAGA|AGTATCGAAGCTATCACTTATTTGGTCGGT
ATAGCCTTATTCGAATATAAATGATCAGTC|GACCAAAGCGAAAGAGTGGACGTCCGTGCA
GAGTGGACGTCCGTGAAGAGTGGACGTCCG|AGTCGCTGGATGGAAGGGGGGCATATATAG
TCGACATACTTACAGCGTGCGTCCTGAGGA|GCAGATACAGCGTAAGAGTGGACGTCCGTG
TATCGTTCCCGCTACTTGACTTTACGGAGA|CAAGACAGTATTACAGCCAGCCCGATATTT
AAACTCACGCGTAGTTCCTACCCTGGGTAG|TATGTATACTTTATCTAAGTTATTGAGCAG
TGCACAAGACAGTATGTATACTTTATCTAA|TTAGCAGCCACAAAGAGTGGACGTCCGTGC
CCGTGCACAAGACAGTATCACAAGACAGTA|TAGCGAAGGAAAAAGCTCCGACCTGCGTCG
CACAAGACAGTATCGGTCTAAAAAATTAGC|CTTACAGGCGATAAAGAGTGGACGTCCGTG
AGAGTGGACGTCCGTAAGAGTGGACGTCCG|TCTAAAATACCAATAAAGCGCCACAAGAGC
ACGCACCTCTCCTTTGAGTGAGCAAGCACC|CTTCAGGAAATTCGTGGCAGATTCAGGATT
TTTTCTAGGTAAGAGTGGACGTCCGTGCAC|TGAAAAGAGTGGACGTCCGTGCACAAGACA
AAAACACATAACATCTATCGGAATGCCTAA|CTCACGCGTAGTTCCTACCCTGGGTAGCCT
TGGACGTCCGTGCACAAGACAGTATCACAA|GCATATATAGCGAAGGAAAAAGCTCCGACC
CCACAAAGAGTGGACGTCCGTGCACAAGAC|ATCGAGTGGAAGGCCGACCTCCGCTGGTTG
TAAGAGTGGACGTCCGTGCACAAGACAGTA|GTGGACGTCCGTGCACAAGACAGTATAAAT
CACAAGACAGTATGTCCGGTTAAAACACAT|AGACAGTATCATGGCACGAAACTCACGCGT
ATACGACAAGAGTGGACGTCCGTAAGAGTG|ATGAGTCGTCTAAAATACCAATAAAGCGCC
AGTGGACGTCCGTGCACAAGACAGTATCGA|CGTCCGTGCACAAGACAGTATACCTTCGCT
GTGCACAAGACAGTATGCACAAGACAGTAT|CCGGGAGTCTCATAGTACTTACAGGCGATA
CACTGTTCTCGCAAGGTCTAAAAGAGTGGA|AAAACACATAACATCTATCGGAATGCCTAA
AGCAGCCACAAAGAGTGGACGTCCGTGCAC|ACAGTATCGAGTGGAAGGCCGACCTCCGCT
CGTAGTTCCTACCCTGGGTAGCCTAAGTCG|TTTATCTAAGTTATTGAGCAGATACGACAA
CCACTGATACAATCCGGCCACACTGTTCTC|ACAAGACAGTATGTCCGGTTAAAACACATA
CAAGACAGTATGTATACTTTATCTAAGTTA|CAGCCACAAAGAGTGGACGTCCGTGCACAA
ATATTTGCCCTTAACGCACCTCTCCTTTGA|ACGTACCTGGAAACTTCAGGAAATTCGTGG
CAGTATATGAGTCGTCTAAAATACCAATAA|GGGAGGTTATTCGTTAAGTTAAGGGCATTC
CTAAGTCGCTGGATGGAAGGGGGGCATATA|TACGACAAGAGTGGACGTCCGTAAGAGTGG
TTGAGTGAGCAAGCACCCTTACATGAGGTC|GTGGCAGATTCAGGATTTTCTAGGTAAGAG
TTAAGTTAAGGGCATTCTGTACAGGAACTG|GTGCGTCCTGAGGACCTATCGTTCCCGCTA
CTCCTTTGAGTGAGCAAGCACCCTTACATG|AATTCGTGGCAGATTCAGGATTTTCTAGGT
AAGAGCCGGGAGTCTCATAGTACTTACAGG|AACTGGCAGTGACAGTTAATAATCGACCAC
AATTAGCGGTATTAGCAGCCACAAAGAGTG|GTCCGTGCACAAGACAGTATCGAGTGGAAG
CATGGTATGTGCAGTTGTCGACATACTTAC|GCTCGCTCGGTAGCTTGGCAGATACAGCGT
GGCAGTGACAGTTAATAATCGACCACGCTG|ACTTGACTTTACGGAGAAAGAGTGGACGTC
GAAATTCGTGGCAGATTCAGGATTTTCTAG|AACGATAGCACGTTGACGCAAATGAAAAGA
CATCTATCGGAATGCCTAAAGAGTGGACGT|TTCCTACCCTGGGTAGCCTAAGTCGCTGGA
GTCCGTGCACAAGACAGTATCGAAGCTATC|GCACAAGACAGTATACCTTCGCTCAGGGAT
CGTGCACAAGACAGTATTACAGCCAGCCCG|ACAAGACAGTATAAATGGGTGACGGTAAAG
TTGGGAGGTTATTCGTTAAGTTAAGGGCAT|CGACATACTTACAGCGTGCGTCCTGAGGAC
AAGAGTGGACGTCCGTGCACAAGACAGTAT|TGTCTTAGTCAAAACAGAGCACGCTTCAAA
TAAAGAGTGGACGTCCGTGAAGAGTGGACG|CCTAAGTCGCTGGATGGAAGGGGGGCATAT
TGGACGTCCGTGCACAAGACAGTATCGAGT|TAGTCAAAACAGAGCACGCTTCAAAAGAAC
GGACGTCCGTGCACAAGACAGTATCGAGTG|AGTCAAAACAGAGCACGCTTCAAAAGAACG
GTCCGTGCACAAGACAGTATCGAGTGGAAG|AAAACAGAGCACGCTTCAAAAGAACGCCAT
ATACTTTATCTAAGTTATTGAGCAGATACG|TGGACGTCCGTGCACAAGACAGTATATGAG
TCCGTGCACAAGACAGTATCATGGCACGAA|TAAGAGTGGACGTCCGTGCACAAGACAGTA
ATCAGTCCACTGATACAATCCGGCCACACT|CCGTGCACAAGACAGTATGTCCGGTTAAAA
ACAGTATGTCCGGTTAAAACACATAACATC|TATCATGGCACGAAACTCACGCGTAGTTCC
AGTATCATGGCACGAAACTCACGCGTAGTT|CGTGCACAAGACAGTATGTATACTTTATCT
TGGACGTCCGTGCACAAGACAGTATGTCCG|CGTCCGTGCACAAGACAGTATCATGGCACG
AAGGGTAGGCTCGCTCGGTAGCTTGGCAGA|TGAGGTCATGCCACTGCGTGCCTCTTCGGT
TATGAGTCGTCTAAAATACCAATAAAGCGC|GTTATTCGTTAAGTTAAGGGCATTCTGTAC
AGGTTATTCGTTAAGTTAAGGGCATTCTGT|TACTTACAGCGTGCGTCCTGAGGACCTATC
CAGTGACAGTTAATAATCGACCACGCTGTT|TTGACTTTACGGAGAAAGAGTGGACGTCCG
AATGATCAGTCCACTGATACAATCCGGCCA|ACGTCCGTGCACAAGACAGTATGTCCGGTT
CTGGAAACTTCAGGAAATTCGTGGCAGATT|AAGGGTAAGATAAAACGATAGCACGTTGAC
TAAGGGCATTCTGTACAGGAACTGGCAGTG|CCTGAGGACCTATCGTTCCCGCTACTTGAC
CCTCTCCTTTGAGTGAGCAAGCACCCTTAC|GGAAATTCGTGGCAGATTCAGGATTTTCTA
AGTGGACGTCCGTGCACAAGACAGTATTAC|ACGTCCGTGCACAAGACAGTATAAATGGGT
CAGTTGTCGACATACTTACAGCGTGCGTCC|AGCTTGGCAGATACAGCGTAAGAGTGGACG
ATTAGCAGCCACAAAGAGTGGACGTCCGTG|AAGACAGTATCGAGTGGAAGGCCGACCTCC
GCAGTGACAGTTAATAATCGACCACGCTGT|CTTGACTTTACGGAGAAAGAGTGGACGTCC
GTCTAAAATACCAATAAAGCGCCACAAGAG|TTAAGTTAAGGGCATTCTGTACAGGAACTG
CCTGAGGACCTATCGTTCCCGCTACTTGAC|CGTCCGTGCACAAGACAGTATTACAGCCAG
GCCACTGCGTGCCTCTTCGGTCGAAAGAGT|GACGTCCGTGCACAAGACAGTATCGAAGCT
ACTGGCATAGCCTTATTCGAATATAAATGA|GAGTGGGACCAAAGCGAAAGAGTGGACGTC
TACAATCCGGCCACACTGTTCTCGCAAGGT|AGTATGTCCGGTTAAAACACATAACATCTA
AAGAGTGGACGTCCGTGCACAAGACAGTAT|GCCCTTAACGCACCTCTCCTTTGAGTGAGC
GTATGTATACTTTATCTAAGTTATTGAGCA|AAAGAGTGGACGTCCGTGCACAAGACAGTA
ACACTGTTCTCGCAAGGTCTAAAAGAGTGG|TAAAACACATAACATCTATCGGAATGCCTA
CGACCACGCTGTTGTCTTAGTCAAAACAGA|GAGTGGACGTCCGTGCACAAGACAGTATTG
ACGGCATCGGAACACTCGGAGTGGGACCAA|TCCGTGCACAAGACAGTATCACAAGACAGT
GTTAAGTTAAGGGCATTCTGTACAGGAACT|CGTGCGTCCTGAGGACCTATCGTTCCCGCT
ACAGCGTAAGAGTGGACGTCCGTGCACAAG|GAAAGAGTGGACGTCCGTGCACAAGACAGT
AACTCACGCGTAGTTCCTACCCTGGGTAGC|ATGTATACTTTATCTAAGTTATTGAGCAGA
GCACAAGACAGTATTTCGTGACGGCATCGG|ACGTCCGTGAAGAGTGGACGTCCGTGCACA
GAGGTTATTCGTTAAGTTAAGGGCATTCTG|ATACTTACAGCGTGCGTCCTGAGGACCTAT
GCACAAGACAGTATCGAGTGGAAGGCCGAC|GAGCACGCTTCAAAAGAACGCCATGGTATG
CGTCCGTGAAGAGTGGACGTCCGTGCACAA|GGATGGAAGGGGGGCATATATAGCGAAGGA
GAGTGGACGTCCGTGCACAAGACAGTATCA|GGGGCATATATAGCGAAGGAAAAAGCTCCG
TTAATAATCGACCACGCTGTTGTCTTAGTC|CGGAGAAAGAGTGGACGTCCGTGCACAAGA
AAGAGTGGACGTCCGTGCACAAGACAGTAT|AAGCGCCACAAGAGCCGGGAGTCTCATAGT
TGTACAGGAACTGGCAGTGACAGTTAATAA|ATCGTTCCCGCTACTTGACTTTACGGAGAA
CGTAAGAGTGGACGTCCGTGCACAAGACAG|ATAAAGCGCCACAAGAGCCGGGAGTCTCAT
ACGTCCGTGCACAAGACAGTATTGCGTATT|CGCACCTCTCCTTTGAGTGAGCAAGCACCC
CACGCTGTTGTCTTAGTCAAAACAGAGCAC|GGACGTCCGTGCACAAGACAGTATTGCGTA
GACGTACCTGGAAACTTCAGGAAATTCGTG|ATGTAGCAAGGGTAAGATAAAACGATAGCA
ATGTGCAGTTGTCGACATACTTACAGCGTG|TCGGTAGCTTGGCAGATACAGCGTAAGAGT
AGGGCATTCTGTACAGGAACTGGCAGTGAC|TGAGGACCTATCGTTCCCGCTACTTGACTT
CAGCGTAAGAGTGGACGTCCGTGCACAAGA|AAAGAGTGGACGTCCGTGCACAAGACAGTA
GGCTATTCTGAACACTGGCATAGCCTTATT|ATCGGAACACTCGGAGTGGGACCAAAGCGA
GTGCACAAGACAGTATTGCGTATTTGCGAA|TCTCCTTTGAGTGAGCAAGCACCCTTACAT
ACAAGACAGTATAAATGGGTGACGGTAAAG|GTCGGTTCGTAGGGACACCAGAGCAATTCA
CGTCGCAGTAATCGTTTAAGAGTGGACGTC|CAAGACAGTATCGGTCTAAAAAATTAGCGG
TATTTGGTCGGTTCGTAGGGACACCAGAGC|ACAAAGGTGCGTAGGGTTGACGACGTAAGG
ACGTCCGTGCACAAGACAGTATGTCCGGTT|CCGTGCACAAGACAGTATCATGGCACGAAA
GGTCATGCCACTGCGTGCCTCTTCGGTCGA|AGAGTGGACGTCCGTGCACAAGACAGTATC
TGGGAGGTTATTCGTTAAGTTAAGGGCATT|GACATACTTACAGCGTGCGTCCTGAGGACC
AAGCTCCGACCTGCGTCGCAGTAATCGTTT|AAGACAGTATGCACAAGACAGTATCGGTCT
GTCCGTGAAGAGTGGACGTCCGTGCACAAG|GATGGAAGGGGGGCATATATAGCGAAGGAA
AGGAAATTCGTGGCAGATTCAGGATTTTCT|AAAACGATAGCACGTTGACGCAAATGAAAA
GCACAAGACAGTATCGAAGCTATCACTTAT|GACAGTATACCTTCGCTCAGGGATGGCACA
AAGGTCTAAAAGAGTGGACGTCCGTGCACA|ATCTATCGGAATGCCTAAAGAGTGGACGTC
AGCGAAAGAGTGGACGTCCGTGCACAAGAC|ATAGAGTGGACGTCCGTGCACAAGACAGTA
ACAGTATCGGTCTAAAAAATTAGCGGTATT|GGCGATAAAGAGTGGACGTCCGTGCACAAG
TTGCGAAAGGGTAGGCTCGCTCGGTAGCTT|CTTACATGAGGTCATGCCACTGCGTGCCTC
GCAAGCACCCTTACATGAGGTCATGCCACT|TTCAGGATTTTCTAGGTAAGAGTGGACGTC
GAACTGGCAGTGACAGTTAATAATCGACCA|CCGCTACTTGACTTTACGGAGAAAGAGTGG
AAGCGCCACAAGAGCCGGGAGTCTCATAGT|CTGTACAGGAACTGGCAGTGACAGTTAATA
ACTCACGCGTAGTTCCTACCCTGGGTAGCC|TGTATACTTTATCTAAGTTATTGAGCAGAT
CGGCCACACTGTTCTCGCAAGGTCTAAAAG|CCGGTTAAAACACATAACATCTATCGGAAT
TGCACAAGACAGTATAAATGGGTGACGGTA|TTGGTCGGTTCGTAGGGACACCAGAGCAAT
ACCTATCGTTCCCGCTACTTGACTTTACGG|GCACAAGACAGTATTACAGCCAGCCCGATA
GACGTCCGTGCACAAGACAGTATCACAAGA|ATATATAGCGAAGGAAAAAGCTCCGACCTG
CAAGACAGTATAGAGTGGACGTCCGTGCAC|ACCTGCGTCGCAGTAATCGTTTAAGAGTGG
CCGACCTCCGCTGGTTGGGAGGTTATTCGT|GTATGTGCAGTTGTCGACATACTTACAGCG
GAAAAAGCTCCGACCTGCGTCGCAGTAATC|GCACAAGACAGTATGCACAAGACAGTATCG
GTGGACGTCCGTGCACAAGACAGTATCGAA|GTCCGTGCACAAGACAGTATACCTTCGCTC
GTAAAGACGTACCTGGAAACTTCAGGAAAT|AATTCATGTAGCAAGGGTAAGATAAAACGA
GTCCGGTTAAAACACATAACATCTATCGGA|GCACGAAACTCACGCGTAGTTCCTACCCTG
CCGTGCACAAGACAGTATCATGGCACGAAA|AAGAGTGGACGTCCGTGCACAAGACAGTAT
TTACGGAGAAAGAGTGGACGTCCGTGCACA|CCGATATTTGCCCTTAACGCACCTCTCCTT
GTATCACAAGACAGTATAGAGTGGACGTCC|GCTCCGACCTGCGTCGCAGTAATCGTTTAA
TCCGTGCACAAGACAGTATGCACAAGACAG|GAGCCGGGAGTCTCATAGTACTTACAGGCG
AGAGTGGACGTCCGTGCACAAGACAGTATC|GGGGGCATATATAGCGAAGGAAAAAGCTCC
TATCACAAGACAGTATAGAGTGGACGTCCG|CTCCGACCTGCGTCGCAGTAATCGTTTAAG
CACCTCTCCTTTGAGTGAGCAAGCACCCTT|CAGGAAATTCGTGGCAGATTCAGGATTTTC
TATTTGCCCTTAACGCACCTCTCCTTTGAG|CGTACCTGGAAACTTCAGGAAATTCGTGGC
TTGACTTTACGGAGAAAGAGTGGACGTCCG|GCCAGCCCGATATTTGCCCTTAACGCACCT
ATAGCGAAGGAAAAAGCTCCGACCTGCGTC|GACGTCCGTGCACAAGACAGTATGCACAAG
GGGCATTCTGTACAGGAACTGGCAGTGACA|GAGGACCTATCGTTCCCGCTACTTGACTTT
TGCACAAGACAGTATGTCCGGTTAAAACAC|CAAGACAGTATCATGGCACGAAACTCACGC
CACTGATACAATCCGGCCACACTGTTCTCG|CAAGACAGTATGTCCGGTTAAAACACATAA
TGGACGTCCGTGCACAAGACAGTATAAATG|TATCACTTATTTGGTCGGTTCGTAGGGACA
ACAGGAACTGGCAGTGACAGTTAATAATCG|GTTCCCGCTACTTGACTTTACGGAGAAAGA
CAGGAACTGGCAGTGACAGTTAATAATCGA|TTCCCGCTACTTGACTTTACGGAGAAAGAG
GTGGACGTCCGTGCACAAGACAGTATATGA|AAGGCCGACCTCCGCTGGTTGGGAGGTTAT
TACAGCGTAAGAGTGGACGTCCGTGCACAA|CGAAAGAGTGGACGTCCGTGCACAAGACAG
CAAAGAGTGGACGTCCGTGCACAAGACAGT|GAGTGGAAGGCCGACCTCCGCTGGTTGGGA
ATACTTACAGCGTGCGTCCTGAGGACCTAT|TACAGCGTAAGAGTGGACGTCCGTGCACAA
TCGGTCTAAAAAATTAGCGGTATTAGCAGC|AAAGAGTGGACGTCCGTGCACAAGACAGTA
CATCGGAACACTCGGAGTGGGACCAAAGCG|TGCACAAGACAGTATCACAAGACAGTATAG
ATCTATCGGAATGCCTAAAGAGTGGACGTC|TCCTACCCTGGGTAGCCTAAGTCGCTGGAT
CTTGACTTTACGGAGAAAGAGTGGACGTCC|AGCCAGCCCGATATTTGCCCTTAACGCACC
TGGTCGGTTCGTAGGGACACCAGAGCAATT|AGGTGCGTAGGGTTGACGACGTAAGGTTAC
TCACTTATTTGGTCGGTTCGTAGGGACACC|ATGGCACAAAGGTGCGTAGGGTTGACGACG
TGCACAAGACAGTATATGAGTCGTCTAAAA|CCGCTGGTTGGGAGGTTATTCGTTAAGTTA
AAGGAAAAAGCTCCGACCTGCGTCGCAGTA|CGTGCACAAGACAGTATGCACAAGACAGTA
AGAGTGGACGTCCGTGCACAAGACAGTATT|GGACGTCCGTGCACAAGACAGTATAAATGG
GTAGCCTAAGTCGCTGGATGGAAGGGGGGC|GCAGATACGACAAGAGTGGACGTCCGTAAG
ACTTGACTTTACGGAGAAAGAGTGGACGTC|CAGCCAGCCCGATATTTGCCCTTAACGCAC
TGGACGTCCGTGCACAAGACAGTATGCACA|CCACAAGAGCCGGGAGTCTCATAGTACTTA
CATGGCACGAAACTCACGCGTAGTTCCTAC|ACAAGACAGTATGTATACTTTATCTAAGTT
ACTTATTTGGTCGGTTCGTAGGGACACCAG|GGCACAAAGGTGCGTAGGGTTGACGACGTA
GACAGTATAGAGTGGACGTCCGTGCACAAG|TGCGTCGCAGTAATCGTTTAAGAGTGGACG
GAGTGGACGTCCGTGCACAAGACAGTATTG|CCTTAACGCACCTCTCCTTTGAGTGAGCAA
GATACAATCCGGCCACACTGTTCTCGCAAG|ACAGTATGTCCGGTTAAAACACATAACATC
GACAAGAGTGGACGTCCGTAAGAGTGGACG|GTCGTCTAAAATACCAATAAAGCGCCACAA
AAGACAGTATCGGTCTAAAAAATTAGCGGT|ACAGGCGATAAAGAGTGGACGTCCGTGCAC
AAAAAATTAGCGGTATTAGCAGCCACAAAG|GGACGTCCGTGCACAAGACAGTATCGAGTG
GACGTCCGTAAGAGTGGACGTCCGTGCACA|ATACCAATAAAGCGCCACAAGAGCCGGGAG
GTACTTACAGGCGATAAAGAGTGGACGTCC|TAATCGACCACGCTGTTGTCTTAGTCAAAA
CACAAGACAGTATAAATGGGTGACGGTAAA|GGTCGGTTCGTAGGGACACCAGAGCAATTC
CGTACCTGGAAACTTCAGGAAATTCGTGGC|GTAGCAAGGGTAAGATAAAACGATAGCACG
GGTATGTGCAGTTGTCGACATACTTACAGC|CGCTCGGTAGCTTGGCAGATACAGCGTAAG
ACGTCCGTGCACAAGACAGTATCGAGTGGA|TCAAAACAGAGCACGCTTCAAAAGAACGCC
GACCGGGCTATTCTGAACACTGGCATAGCC|ACGGCATCGGAACACTCGGAGTGGGACCAA
GCAGATACGACAAGAGTGGACGTCCGTAAG|GTATATGAGTCGTCTAAAATACCAATAAAG
GTCCGTGCACAAGACAGTATTGCGTATTTG|CACCTCTCCTTTGAGTGAGCAAGCACCCTT
TCTAAAATACCAATAAAGCGCCACAAGAGC|TAAGTTAAGGGCATTCTGTACAGGAACTGG
TATGTCCGGTTAAAACACATAACATCTATC|ATGGCACGAAACTCACGCGTAGTTCCTACC
ACGTCCGTGCACAAGACAGTATTACAGCCA|CGTGCACAAGACAGTATAAATGGGTGACGG
GGTAAAGACGTACCTGGAAACTTCAGGAAA|CAATTCATGTAGCAAGGGTAAGATAAAACG
CGTGCACAAGACAGTATCACAAGACAGTAT|AGCGAAGGAAAAAGCTCCGACCTGCGTCGC
GATAAAGAGTGGACGTCCGTGCACAAGACA|CTGTTGTCTTAGTCAAAACAGAGCACGCTT
CACTGCGTGCCTCTTCGGTCGAAAGAGTGG|CGTCCGTGCACAAGACAGTATCGAAGCTAT
CCGTGCACAAGACAGTATCGAGTGGAAGGC|AACAGAGCACGCTTCAAAAGAACGCCATGG
TAAAACACATAACATCTATCGGAATGCCTA|ACTCACGCGTAGTTCCTACCCTGGGTAGCC
AGCCCGATATTTGCCCTTAACGCACCTCTC|GTAAAGACGTACCTGGAAACTTCAGGAAAT
CACTTATTTGGTCGGTTCGTAGGGACACCA|TGGCACAAAGGTGCGTAGGGTTGACGACGT
AAGAGTGGACGTCCGTAAGAGTGGACGTCC|GTCTAAAATACCAATAAAGCGCCACAAGAG
CCGTAAGAGTGGACGTCCGTGCACAAGACA|AATAAAGCGCCACAAGAGCCGGGAGTCTCA
CGCTGGTTGGGAGGTTATTCGTTAAGTTAA|AGTTGTCGACATACTTACAGCGTGCGTCCT
CTGCGTGCCTCTTCGGTCGAAAGAGTGGAC|TCCGTGCACAAGACAGTATCGAAGCTATCA
GTATTTGCGAAAGGGTAGGCTCGCTCGGTA|CACCCTTACATGAGGTCATGCCACTGCGTG
GCACGCTTCAAAAGAACGCCATGGTATGTG|CGTATTTGCGAAAGGGTAGGCTCGCTCGGT
AAAGCGAAAGAGTGGACGTCCGTGCACAAG|GTATAGAGTGGACGTCCGTGCACAAGACAG
TAAATGGGTGACGGTAAAGACGTACCTGGA|GGGACACCAGAGCAATTCATGTAGCAAGGG
GTGGACGTCCGTGCACAAGACAGTATGTAT|AATTAGCGGTATTAGCAGCCACAAAGAGTG
AGAACGCCATGGTATGTGCAGTTGTCGACA|AGGGTAGGCTCGCTCGGTAGCTTGGCAGAT
TGACGGTAAAGACGTACCTGGAAACTTCAG|AGAGCAATTCATGTAGCAAGGGTAAGATAA
GATGGAAGGGGGGCATATATAGCGAAGGAA|TGGACGTCCGTAAGAGTGGACGTCCGTGCA
CGGAATGCCTAAAGAGTGGACGTCCGTGAA|CCTGGGTAGCCTAAGTCGCTGGATGGAAGG
AGATTCAGGATTTTCTAGGTAAGAGTGGAC|TTGACGCAAATGAAAAGAGTGGACGTCCGT
GTATGTGCAGTTGTCGACATACTTACAGCG|GCTCGGTAGCTTGGCAGATACAGCGTAAGA
AGTGGACGTCCGTGCACAAGACAGTATGCA|CGCCACAAGAGCCGGGAGTCTCATAGTACT
GTGGCAGATTCAGGATTTTCTAGGTAAGAG|GCACGTTGACGCAAATGAAAAGAGTGGACG
AGTATATGAGTCGTCTAAAATACCAATAAA|GGAGGTTATTCGTTAAGTTAAGGGCATTCT
CTATCGTTCCCGCTACTTGACTTTACGGAG|ACAAGACAGTATTACAGCCAGCCCGATATT
CCTTTGAGTGAGCAAGCACCCTTACATGAG|TTCGTGGCAGATTCAGGATTTTCTAGGTAA
AGGCCGACCTCCGCTGGTTGGGAGGTTATT|ATGGTATGTGCAGTTGTCGACATACTTACA
GGTAGCTTGGCAGATACAGCGTAAGAGTGG|CGTGCCTCTTCGGTCGAAAGAGTGGACGTC
TTAGCAGCCACAAAGAGTGGACGTCCGTGC|AGACAGTATCGAGTGGAAGGCCGACCTCCG
AAGACAGTATGCACAAGACAGTATCGGTCT|GTCTCATAGTACTTACAGGCGATAAAGAGT
TGGTATGTGCAGTTGTCGACATACTTACAG|TCGCTCGGTAGCTTGGCAGATACAGCGTAA
GGAATGCCTAAAGAGTGGACGTCCGTGAAG|CTGGGTAGCCTAAGTCGCTGGATGGAAGGG
TAGCAGCCACAAAGAGTGGACGTCCGTGCA|GACAGTATCGAGTGGAAGGCCGACCTCCGC
CACTGGCATAGCCTTATTCGAATATAAATG|GGAGTGGGACCAAAGCGAAAGAGTGGACGT
AAAGAGTGGACGTCCGTGCACAAGACAGTA|GAATGCCTAAAGAGTGGACGTCCGTGAAGA
GTATCGAAGCTATCACTTATTTGGTCGGTT|CTTCGCTCAGGGATGGCACAAAGGTGCGTA
ATCACAAGACAGTATAGAGTGGACGTCCGT|TCCGACCTGCGTCGCAGTAATCGTTTAAGA
AAGACAGTATAAATGGGTGACGGTAAAGAC|CGGTTCGTAGGGACACCAGAGCAATTCATG
TCATGCCACTGCGTGCCTCTTCGGTCGAAA|AGTGGACGTCCGTGCACAAGACAGTATCGA
GTATTAGCAGCCACAAAGAGTGGACGTCCG|ACAAGACAGTATCGAGTGGAAGGCCGACCT
GCGAAAGGGTAGGCTCGCTCGGTAGCTTGG|TACATGAGGTCATGCCACTGCGTGCCTCTT
GAGTGGGACCAAAGCGAAAGAGTGGACGTC|TCACAAGACAGTATAGAGTGGACGTCCGTG
CTAAGTTATTGAGCAGATACGACAAGAGTG|GTGCACAAGACAGTATATGAGTCGTCTAAA
CAATAAAGCGCCACAAGAGCCGGGAGTCTC|GCATTCTGTACAGGAACTGGCAGTGACAGT
CAAAAGAACGCCATGGTATGTGCAGTTGTC|CGAAAGGGTAGGCTCGCTCGGTAGCTTGGC
GCTATTCTGAACACTGGCATAGCCTTATTC|TCGGAACACTCGGAGTGGGACCAAAGCGAA
GGGCTATTCTGAACACTGGCATAGCCTTAT|CATCGGAACACTCGGAGTGGGACCAAAGCG
CATACTTACAGCGTGCGTCCTGAGGACCTA|ATACAGCGTAAGAGTGGACGTCCGTGCACA
CACCCTTACATGAGGTCATGCCACTGCGTG|GATTTTCTAGGTAAGAGTGGACGTCCGTGC
TGGAAGGGGGGCATATATAGCGAAGGAAAA|GACGTCCGTAAGAGTGGACGTCCGTGCACA
CGGGAGTCTCATAGTACTTACAGGCGATAA|CAGTGACAGTTAATAATCGACCACGCTGTT
TCTTCGGTCGAAAGAGTGGACGTCCGTGCA|AAGACAGTATCGAAGCTATCACTTATTTGG
AACTGGCAGTGACAGTTAATAATCGACCAC|CGCTACTTGACTTTACGGAGAAAGAGTGGA
CTTCAAAAGAACGCCATGGTATGTGCAGTT|TTGCGAAAGGGTAGGCTCGCTCGGTAGCTT
AGTGGACGTCCGTGCACAAGACAGTATGTC|GACGTCCGTGCACAAGACAGTATCATGGCA
CCTAAAGAGTGGACGTCCGTGAAGAGTGGA|AGCCTAAGTCGCTGGATGGAAGGGGGGCAT
GACGTCCGTGCACAAGACAGTATATGAGTC|GCCGACCTCCGCTGGTTGGGAGGTTATTCG
AGAGTGGACGTCCGTGCACAAGACAGTATC|GTCTTAGTCAAAACAGAGCACGCTTCAAAA
CTGATACAATCCGGCCACACTGTTCTCGCA|AGACAGTATGTCCGGTTAAAACACATAACA
GGGAGTCTCATAGTACTTACAGGCGATAAA|AGTGACAGTTAATAATCGACCACGCTGTTG
GTCCGTGCACAAGACAGTATCATGGCACGA|TTAAGAGTGGACGTCCGTGCACAAGACAGT
AATAATCGACCACGCTGTTGTCTTAGTCAA|GAGAAAGAGTGGACGTCCGTGCACAAGACA
AGCGTAAGAGTGGACGTCCGTGCACAAGAC|AAGAGTGGACGTCCGTGCACAAGACAGTAT
GGGAGGTTATTCGTTAAGTTAAGGGCATTC|ACATACTTACAGCGTGCGTCCTGAGGACCT
TCCACTGATACAATCCGGCCACACTGTTCT|CACAAGACAGTATGTCCGGTTAAAACACAT
TGGCAGATACAGCGTAAGAGTGGACGTCCG|CTTCGGTCGAAAGAGTGGACGTCCGTGCAC
CACAAGAGCCGGGAGTCTCATAGTACTTAC|AGGAACTGGCAGTGACAGTTAATAATCGAC
GCCTTATTCGAATATAAATGATCAGTCCAC|CAAAGCGAAAGAGTGGACGTCCGTGCACAA
GTATCATGGCACGAAACTCACGCGTAGTTC|GTGCACAAGACAGTATGTATACTTTATCTA
GTGAGCAAGCACCCTTACATGAGGTCATGC|CAGATTCAGGATTTTCTAGGTAAGAGTGGA
GTGCGTCCTGAGGACCTATCGTTCCCGCTA|AGTGGACGTCCGTGCACAAGACAGTATTAC
ACAGTATCGAGTGGAAGGCCGACCTCCGCT|CTTCAAAAGAACGCCATGGTATGTGCAGTT
GTCTTAGTCAAAACAGAGCACGCTTCAAAA|TGCACAAGACAGTATTGCGTATTTGCGAAA
CAGGAAATTCGTGGCAGATTCAGGATTTTC|TAAAACGATAGCACGTTGACGCAAATGAAA
ACGTACCTGGAAACTTCAGGAAATTCGTGG|TGTAGCAAGGGTAAGATAAAACGATAGCAC
CAGTATCGGTCTAAAAAATTAGCGGTATTA|GCGATAAAGAGTGGACGTCCGTGCACAAGA
CGTGCACAAGACAGTATCATGGCACGAAAC|AGAGTGGACGTCCGTGCACAAGACAGTATG
CCTGCGTCGCAGTAATCGTTTAAGAGTGGA|TGCACAAGACAGTATCGGTCTAAAAAATTA
CGGAACACTCGGAGTGGGACCAAAGCGAAA|ACAAGACAGTATCACAAGACAGTATAGAGT
TATATAGCGAAGGAAAAAGCTCCGACCTGC|GTGGACGTCCGTGCACAAGACAGTATGCAC
TGAGGACCTATCGTTCCCGCTACTTGACTT|TCCGTGCACAAGACAGTATTACAGCCAGCC
AAACAGAGCACGCTTCAAAAGAACGCCATG|AGTATTGCGTATTTGCGAAAGGGTAGGCTC
GGAACACTCGGAGTGGGACCAAAGCGAAAG|CAAGACAGTATCACAAGACAGTATAGAGTG
CCGTGCACAAGACAGTATGCACAAGACAGT|AGCCGGGAGTCTCATAGTACTTACAGGCGA
AGTATTACAGCCAGCCCGATATTTGCCCTT|AAATGGGTGACGGTAAAGACGTACCTGGAA
TGGAAGGCCGACCTCCGCTGGTTGGGAGGT|CGCCATGGTATGTGCAGTTGTCGACATACT
GCAAGGTCTAAAAGAGTGGACGTCCGTGCA|ACATCTATCGGAATGCCTAAAGAGTGGACG
CTTATTCGAATATAAATGATCAGTCCACTG|AAGCGAAAGAGTGGACGTCCGTGCACAAGA
ATATGAGTCGTCTAAAATACCAATAAAGCG|GGTTATTCGTTAAGTTAAGGGCATTCTGTA
GTCCGTAAGAGTGGACGTCCGTGCACAAGA|CCAATAAAGCGCCACAAGAGCCGGGAGTCT
TAAGAGTGGACGTCCGTGCACAAGACAGTA|TGGACGTCCGTGCACAAGACAGTATACCTT
GTCTAAAAGAGTGGACGTCCGTGCACAAGA|TATCGGAATGCCTAAAGAGTGGACGTCCGT
TATTAGCAGCCACAAAGAGTGGACGTCCGT|CAAGACAGTATCGAGTGGAAGGCCGACCTC
AGCGTGCGTCCTGAGGACCTATCGTTCCCG|AAGAGTGGACGTCCGTGCACAAGACAGTAT
TCCGGTTAAAACACATAACATCTATCGGAA|CACGAAACTCACGCGTAGTTCCTACCCTGG
GTAGGCTCGCTCGGTAGCTTGGCAGATACA|GTCATGCCACTGCGTGCCTCTTCGGTCGAA
AGAGTGGACGTCCGTGCACAAGACAGTATA|AAGCTATCACTTATTTGGTCGGTTCGTAGG
TGGACGTCCGTGCACAAGACAGTATATGAG|AGGCCGACCTCCGCTGGTTGGGAGGTTATT
ATGAGTCGTCTAAAATACCAATAAAGCGCC|TTATTCGTTAAGTTAAGGGCATTCTGTACA
AGTCCACTGATACAATCCGGCCACACTGTT|TGCACAAGACAGTATGTCCGGTTAAAACAC
CAATCCGGCCACACTGTTCTCGCAAGGTCT|TATGTCCGGTTAAAACACATAACATCTATC
GGCTCGCTCGGTAGCTTGGCAGATACAGCG|ATGCCACTGCGTGCCTCTTCGGTCGAAAGA
ATTCTGAACACTGGCATAGCCTTATTCGAA|GAACACTCGGAGTGGGACCAAAGCGAAAGA
GCACAAGACAGTATGCACAAGACAGTATCG|GGGAGTCTCATAGTACTTACAGGCGATAAA
ACATAACATCTATCGGAATGCCTAAAGAGT|GCGTAGTTCCTACCCTGGGTAGCCTAAGTC
CTCATAGTACTTACAGGCGATAAAGAGTGG|AGTTAATAATCGACCACGCTGTTGTCTTAG
ACAAGACAGTATCACAAGACAGTATAGAGT|AGGAAAAAGCTCCGACCTGCGTCGCAGTAA
ACAAGAGCCGGGAGTCTCATAGTACTTACA|GGAACTGGCAGTGACAGTTAATAATCGACC
CTAAAATACCAATAAAGCGCCACAAGAGCC|AAGTTAAGGGCATTCTGTACAGGAACTGGC
AAAAATTAGCGGTATTAGCAGCCACAAAGA|GACGTCCGTGCACAAGACAGTATCGAGTGG
TTATTCGTTAAGTTAAGGGCATTCTGTACA|TTACAGCGTGCGTCCTGAGGACCTATCGTT
CGTGAAGAGTGGACGTCCGTGCACAAGACA|GGAAGGGGGGCATATATAGCGAAGGAAAAA
GACCAAAGCGAAAGAGTGGACGTCCGTGCA|GACAGTATAGAGTGGACGTCCGTGCACAAG
AGTATCGGTCTAAAAAATTAGCGGTATTAG|CGATAAAGAGTGGACGTCCGTGCACAAGAC
GTGGACGTCCGTGCACAAGACAGTATCGAG|TTAGTCAAAACAGAGCACGCTTCAAAAGAA
GCCTCTTCGGTCGAAAGAGTGGACGTCCGT|CACAAGACAGTATCGAAGCTATCACTTATT
AGGACCTATCGTTCCCGCTACTTGACTTTA|CGTGCACAAGACAGTATTACAGCCAGCCCG
TGATCAGTCCACTGATACAATCCGGCCACA|GTCCGTGCACAAGACAGTATGTCCGGTTAA
CCTCCGCTGGTTGGGAGGTTATTCGTTAAG|GTGCAGTTGTCGACATACTTACAGCGTGCG
AAAGCGCCACAAGAGCCGGGAGTCTCATAG|TCTGTACAGGAACTGGCAGTGACAGTTAAT
GAGGACCTATCGTTCCCGCTACTTGACTTT|CCGTGCACAAGACAGTATTACAGCCAGCCC
TATTTCGTGACGGCATCGGAACACTCGGAG|GAGTGGACGTCCGTGCACAAGACAGTATCA
GTAGCTTGGCAGATACAGCGTAAGAGTGGA|GTGCCTCTTCGGTCGAAAGAGTGGACGTCC
AAGAGTGGACGTCCGTGAAGAGTGGACGTC|TAAGTCGCTGGATGGAAGGGGGGCATATAT
GACCTGCGTCGCAGTAATCGTTTAAGAGTG|TATGCACAAGACAGTATCGGTCTAAAAAAT
ACAAGACAGTATTACAGCCAGCCCGATATT|ACAGTATAAATGGGTGACGGTAAAGACGTA
ACCACGCTGTTGTCTTAGTCAAAACAGAGC|GTGGACGTCCGTGCACAAGACAGTATTGCG
AGCACCCTTACATGAGGTCATGCCACTGCG|AGGATTTTCTAGGTAAGAGTGGACGTCCGT
CGTCCGTGCACAAGACAGTATTGCGTATTT|GCACCTCTCCTTTGAGTGAGCAAGCACCCT
TCCGTGCACAAGACAGTATCGAGTGGAAGG|AAACAGAGCACGCTTCAAAAGAACGCCATG
CTGGATGGAAGGGGGGCATATATAGCGAAG|GAGTGGACGTCCGTAAGAGTGGACGTCCGT
AGCCTTATTCGAATATAAATGATCAGTCCA|CCAAAGCGAAAGAGTGGACGTCCGTGCACA
TCGCAGTAATCGTTTAAGAGTGGACGTCCG|AGACAGTATCGGTCTAAAAAATTAGCGGTA
GACGTCCGTGCACAAGACAGTATCGAAGCT|CGTGCACAAGACAGTATACCTTCGCTCAGG
ACTGATACAATCCGGCCACACTGTTCTCGC|AAGACAGTATGTCCGGTTAAAACACATAAC
GTACAGGAACTGGCAGTGACAGTTAATAAT|TCGTTCCCGCTACTTGACTTTACGGAGAAA
TACAGCGTGCGTCCTGAGGACCTATCGTTC|CGTAAGAGTGGACGTCCGTGCACAAGACAG
GGACGTCCGTGCACAAGACAGTATGCACAA|CACAAGAGCCGGGAGTCTCATAGTACTTAC
TACAGGAACTGGCAGTGACAGTTAATAATC|CGTTCCCGCTACTTGACTTTACGGAGAAAG
CAGTCCACTGATACAATCCGGCCACACTGT|GTGCACAAGACAGTATGTCCGGTTAAAACA
CGCTGTTGTCTTAGTCAAAACAGAGCACGC|ACGTCCGTGCACAAGACAGTATTGCGTATT
AGAGTGGACGTCCGTGCACAAGACAGTATA|TGGAAGGCCGACCTCCGCTGGTTGGGAGGT
GCGTGCCTCTTCGGTCGAAAGAGTGGACGT|CGTGCACAAGACAGTATCGAAGCTATCACT
TTTAAGAGTGGACGTCCGTGCACAAGACAG|TCTAAAAAATTAGCGGTATTAGCAGCCACA
AAGAGTGGACGTCCGTGCACAAGACAGTAT|AATGCCTAAAGAGTGGACGTCCGTGAAGAG
GAGCAGATACGACAAGAGTGGACGTCCGTA|CAGTATATGAGTCGTCTAAAATACCAATAA
AATAAAGCGCCACAAGAGCCGGGAGTCTCA|CATTCTGTACAGGAACTGGCAGTGACAGTT
CCGGGCTATTCTGAACACTGGCATAGCCTT|GGCATCGGAACACTCGGAGTGGGACCAAAG
TGAGGTCATGCCACTGCGTGCCTCTTCGGT|GTAAGAGTGGACGTCCGTGCACAAGACAGT
ATGGAAGGGGGGCATATATAGCGAAGGAAA|GGACGTCCGTAAGAGTGGACGTCCGTGCAC
GTCCGTGCACAAGACAGTATAAATGGGTGA|CTTATTTGGTCGGTTCGTAGGGACACCAGA
TCAGGAAATTCGTGGCAGATTCAGGATTTT|ATAAAACGATAGCACGTTGACGCAAATGAA
GACCTCCGCTGGTTGGGAGGTTATTCGTTA|ATGTGCAGTTGTCGACATACTTACAGCGTG
GTTATTGAGCAGATACGACAAGAGTGGACG|ACAAGACAGTATATGAGTCGTCTAAAATAC
AGACAGTATAGAGTGGACGTCCGTGCACAA|CTGCGTCGCAGTAATCGTTTAAGAGTGGAC
CTAAAAGAGTGGACGTCCGTGCACAAGACA|TCGGAATGCCTAAAGAGTGGACGTCCGTGA
GTGGAAGGCCGACCTCCGCTGGTTGGGAGG|ACGCCATGGTATGTGCAGTTGTCGACATAC
TCAGTCCACTGATACAATCCGGCCACACTG|CGTGCACAAGACAGTATGTCCGGTTAAAAC
GATTTTCTAGGTAAGAGTGGACGTCCGTGC|AATGAAAAGAGTGGACGTCCGTGCACAAGA
GAAGAGTGGACGTCCGTGCACAAGACAGTA|AGGGGGGCATATATAGCGAAGGAAAAAGCT
GCAGTTGTCGACATACTTACAGCGTGCGTC|TAGCTTGGCAGATACAGCGTAAGAGTGGAC
CTACTTGACTTTACGGAGAAAGAGTGGACG|TACAGCCAGCCCGATATTTGCCCTTAACGC
ACAAGACAGTATGTCCGGTTAAAACACATA|GACAGTATCATGGCACGAAACTCACGCGTA
CGTCCTGAGGACCTATCGTTCCCGCTACTT|GGACGTCCGTGCACAAGACAGTATTACAGC
CGATATTTGCCCTTAACGCACCTCTCCTTT|AGACGTACCTGGAAACTTCAGGAAATTCGT
GAACACTCGGAGTGGGACCAAAGCGAAAGA|AAGACAGTATCACAAGACAGTATAGAGTGG
GTCGCAGTAATCGTTTAAGAGTGGACGTCC|AAGACAGTATCGGTCTAAAAAATTAGCGGT
AGTGACAGTTAATAATCGACCACGCTGTTG|TGACTTTACGGAGAAAGAGTGGACGTCCGT
GTATTGCGTATTTGCGAAAGGGTAGGCTCG|GAGCAAGCACCCTTACATGAGGTCATGCCA
TGTCCGGTTAAAACACATAACATCTATCGG|GGCACGAAACTCACGCGTAGTTCCTACCCT
TCTAAAAAATTAGCGGTATTAGCAGCCACA|AGTGGACGTCCGTGCACAAGACAGTATCGA
ATACAGCGTAAGAGTGGACGTCCGTGCACA|TCGAAAGAGTGGACGTCCGTGCACAAGACA
GCTTCAAAAGAACGCCATGGTATGTGCAGT|TTTGCGAAAGGGTAGGCTCGCTCGGTAGCT
AAGACAGTATATGAGTCGTCTAAAATACCA|GGTTGGGAGGTTATTCGTTAAGTTAAGGGC
ATTTGCCCTTAACGCACCTCTCCTTTGAGT|GTACCTGGAAACTTCAGGAAATTCGTGGCA
AGCAAGCACCCTTACATGAGGTCATGCCAC|ATTCAGGATTTTCTAGGTAAGAGTGGACGT
GGAAGGCCGACCTCCGCTGGTTGGGAGGTT|GCCATGGTATGTGCAGTTGTCGACATACTT
TTCGAATATAAATGATCAGTCCACTGATAC|GAAAGAGTGGACGTCCGTGCACAAGACAGT
GAGTGGACGTCCGTGCACAAGACAGTATGT|GGACGTCCGTGCACAAGACAGTATCATGGC
AGCCAGCCCGATATTTGCCCTTAACGCACC|GACGGTAAAGACGTACCTGGAAACTTCAGG
GTAGTTCCTACCCTGGGTAGCCTAAGTCGC|TTATCTAAGTTATTGAGCAGATACGACAAG
TTAAGAGTGGACGTCCGTGCACAAGACAGT|CTAAAAAATTAGCGGTATTAGCAGCCACAA
CAAGACAGTATATGAGTCGTCTAAAATACC|TGGTTGGGAGGTTATTCGTTAAGTTAAGGG
GAAGGCCGACCTCCGCTGGTTGGGAGGTTA|CCATGGTATGTGCAGTTGTCGACATACTTA
CAAGACAGTATCACAAGACAGTATAGAGTG|GGAAAAAGCTCCGACCTGCGTCGCAGTAAT
GTGGACGTCCGTGCACAAGACAGTATTACA|CGTCCGTGCACAAGACAGTATAAATGGGTG
GGACGTCCGTGCACAAGACAGTATATGAGT|GGCCGACCTCCGCTGGTTGGGAGGTTATTC
TCCGTGCACAAGACAGTATGTCCGGTTAAA|TGCACAAGACAGTATCATGGCACGAAACTC
CGCACCTCTCCTTTGAGTGAGCAAGCACCC|TTCAGGAAATTCGTGGCAGATTCAGGATTT
GACGTCCGTGCACAAGACAGTATTGCGTAT|ACGCACCTCTCCTTTGAGTGAGCAAGCACC
ACGGTAAAGACGTACCTGGAAACTTCAGGA|AGCAATTCATGTAGCAAGGGTAAGATAAAA
CAAGACAGTATCATGGCACGAAACTCACGC|GACGTCCGTGCACAAGACAGTATGTATACT
TTAAAACACATAACATCTATCGGAATGCCT|AACTCACGCGTAGTTCCTACCCTGGGTAGC
AGCCACAAAGAGTGGACGTCCGTGCACAAG|GTATCGAGTGGAAGGCCGACCTCCGCTGGT
CAAGACAGTATTACAGCCAGCCCGATATTT|CAGTATAAATGGGTGACGGTAAAGACGTAC
TCGTGGCAGATTCAGGATTTTCTAGGTAAG|TAGCACGTTGACGCAAATGAAAAGAGTGGA
GGACGTCCGTGCACAAGACAGTATCGAAGC|CCGTGCACAAGACAGTATACCTTCGCTCAG
CGTGACGGCATCGGAACACTCGGAGTGGGA|GACGTCCGTGCACAAGACAGTATCACAAGA
CGCTTCAAAAGAACGCCATGGTATGTGCAG|ATTTGCGAAAGGGTAGGCTCGCTCGGTAGC
CAAGCACCCTTACATGAGGTCATGCCACTG|TCAGGATTTTCTAGGTAAGAGTGGACGTCC
GGCATAGCCTTATTCGAATATAAATGATCA|TGGGACCAAAGCGAAAGAGTGGACGTCCGT
ATGGGTGACGGTAAAGACGTACCTGGAAAC|ACACCAGAGCAATTCATGTAGCAAGGGTAA
TAATAATCGACCACGCTGTTGTCTTAGTCA|GGAGAAAGAGTGGACGTCCGTGCACAAGAC
TGCACAAGACAGTATCATGGCACGAAACTC|AGTGGACGTCCGTGCACAAGACAGTATGTA
GAGTGGACGTCCGTGCACAAGACAGTATAA|AGCTATCACTTATTTGGTCGGTTCGTAGGG
TGCCTCTTCGGTCGAAAGAGTGGACGTCCG|GCACAAGACAGTATCGAAGCTATCACTTAT
ACTTTACGGAGAAAGAGTGGACGTCCGTGC|AGCCCGATATTTGCCCTTAACGCACCTCTC
GACAGTATCGAAGCTATCACTTATTTGGTC|ATACCTTCGCTCAGGGATGGCACAAAGGTG
AGTGGACGTCCGTGCACAAGACAGTATTTC|GCCTAAAGAGTGGACGTCCGTGAAGAGTGG
CCACGCTGTTGTCTTAGTCAAAACAGAGCA|TGGACGTCCGTGCACAAGACAGTATTGCGT
GGAAGGGGGGCATATATAGCGAAGGAAAAA|ACGTCCGTAAGAGTGGACGTCCGTGCACAA
TCCTTTGAGTGAGCAAGCACCCTTACATGA|ATTCGTGGCAGATTCAGGATTTTCTAGGTA
CTCCGCTGGTTGGGAGGTTATTCGTTAAGT|TGCAGTTGTCGACATACTTACAGCGTGCGT
TTCGTGACGGCATCGGAACACTCGGAGTGG|TGGACGTCCGTGCACAAGACAGTATCACAA
CCTAAGTCGCTGGATGGAAGGGGGGCATAT|ATACGACAAGAGTGGACGTCCGTAAGAGTG
CAGTATGCACAAGACAGTATCGGTCTAAAA|CATAGTACTTACAGGCGATAAAGAGTGGAC
GACCTATCGTTCCCGCTACTTGACTTTACG|TGCACAAGACAGTATTACAGCCAGCCCGAT
CGGAGTGGGACCAAAGCGAAAGAGTGGACG|TATCACAAGACAGTATAGAGTGGACGTCCG
GCCTAAGTCGCTGGATGGAAGGGGGGCATA|GATACGACAAGAGTGGACGTCCGTAAGAGT
ACAGCGTGCGTCCTGAGGACCTATCGTTCC|GTAAGAGTGGACGTCCGTGCACAAGACAGT
GATCAGTCCACTGATACAATCCGGCCACAC|TCCGTGCACAAGACAGTATGTCCGGTTAAA
AAAATTAGCGGTATTAGCAGCCACAAAGAG|ACGTCCGTGCACAAGACAGTATCGAGTGGA
TCGGTAGCTTGGCAGATACAGCGTAAGAGT|TGCGTGCCTCTTCGGTCGAAAGAGTGGACG
CGAAACTCACGCGTAGTTCCTACCCTGGGT|AGTATGTATACTTTATCTAAGTTATTGAGC
CTTACAGCGTGCGTCCTGAGGACCTATCGT|AGCGTAAGAGTGGACGTCCGTGCACAAGAC
CCGTGCACAAGACAGTATCGAAGCTATCAC|ACAAGACAGTATACCTTCGCTCAGGGATGG
GTCGCTGGATGGAAGGGGGGCATATATAGC|ACAAGAGTGGACGTCCGTAAGAGTGGACGT
AGAGTGGACGTCCGTGCACAAGACAGTATT|ATGCCTAAAGAGTGGACGTCCGTGAAGAGT
TGGACGTCCGTGCACAAGACAGTATGTATA|ATTAGCGGTATTAGCAGCCACAAAGAGTGG
TGGACGTCCGTGCACAAGACAGTATTACAG|GTCCGTGCACAAGACAGTATAAATGGGTGA
ACCAAAGCGAAAGAGTGGACGTCCGTGCAC|ACAGTATAGAGTGGACGTCCGTGCACAAGA
TTTGCCCTTAACGCACCTCTCCTTTGAGTG|TACCTGGAAACTTCAGGAAATTCGTGGCAG
ACGACAAGAGTGGACGTCCGTAAGAGTGGA|GAGTCGTCTAAAATACCAATAAAGCGCCAC
AACAGAGCACGCTTCAAAAGAACGCCATGG|GTATTGCGTATTTGCGAAAGGGTAGGCTCG
ATAAATGGGTGACGGTAAAGACGTACCTGG|AGGGACACCAGAGCAATTCATGTAGCAAGG
GAGCCGGGAGTCTCATAGTACTTACAGGCG|CTGGCAGTGACAGTTAATAATCGACCACGC
GCACAAGACAGTATCGGTCTAAAAAATTAG|ACTTACAGGCGATAAAGAGTGGACGTCCGT
GTGACAGTTAATAATCGACCACGCTGTTGT|GACTTTACGGAGAAAGAGTGGACGTCCGTG
GGGGGGCATATATAGCGAAGGAAAAAGCTC|CCGTAAGAGTGGACGTCCGTGCACAAGACA
AGACAGTATCATGGCACGAAACTCACGCGT|CGTCCGTGCACAAGACAGTATGTATACTTT
TCGGAACACTCGGAGTGGGACCAAAGCGAA|CACAAGACAGTATCACAAGACAGTATAGAG
GAAACTCACGCGTAGTTCCTACCCTGGGTA|GTATGTATACTTTATCTAAGTTATTGAGCA
TCTCATAGTACTTACAGGCGATAAAGAGTG|CAGTTAATAATCGACCACGCTGTTGTCTTA
AGGGGGGCATATATAGCGAAGGAAAAAGCT|TCCGTAAGAGTGGACGTCCGTGCACAAGAC
CCCGATATTTGCCCTTAACGCACCTCTCCT|AAAGACGTACCTGGAAACTTCAGGAAATTC
TGTTGTCTTAGTCAAAACAGAGCACGCTTC|TCCGTGCACAAGACAGTATTGCGTATTTGC
CTCCGACCTGCGTCGCAGTAATCGTTTAAG|ACAGTATGCACAAGACAGTATCGGTCTAAA
ATATATAGCGAAGGAAAAAGCTCCGACCTG|AGTGGACGTCCGTGCACAAGACAGTATGCA
TCAAAAGAACGCCATGGTATGTGCAGTTGT|GCGAAAGGGTAGGCTCGCTCGGTAGCTTGG
AAAGAGTGGACGTCCGTGCACAAGACAGTA|TTGTCTTAGTCAAAACAGAGCACGCTTCAA
AAGTTAAGGGCATTCTGTACAGGAACTGGC|GCGTCCTGAGGACCTATCGTTCCCGCTACT
ACAAGACAGTATCGAGTGGAAGGCCGACCT|GCACGCTTCAAAAGAACGCCATGGTATGTG
TTATCTAAGTTATTGAGCAGATACGACAAG|GTCCGTGCACAAGACAGTATATGAGTCGTC
CTATCGGAATGCCTAAAGAGTGGACGTCCG|CTACCCTGGGTAGCCTAAGTCGCTGGATGG
TGCACAAGACAGTATCACAAGACAGTATAG|CGAAGGAAAAAGCTCCGACCTGCGTCGCAG
ATTTTCTAGGTAAGAGTGGACGTCCGTGCA|ATGAAAAGAGTGGACGTCCGTGCACAAGAC
GTATGTCCGGTTAAAACACATAACATCTAT|CATGGCACGAAACTCACGCGTAGTTCCTAC
GCAGATTCAGGATTTTCTAGGTAAGAGTGG|CGTTGACGCAAATGAAAAGAGTGGACGTCC
CGTCCGTGCACAAGACAGTATTACAGCCAG|GTGCACAAGACAGTATAAATGGGTGACGGT
GCACAAGACAGTATTACAGCCAGCCCGATA|AGACAGTATAAATGGGTGACGGTAAAGACG
TCGAGTGGAAGGCCGACCTCCGCTGGTTGG|AAGAACGCCATGGTATGTGCAGTTGTCGAC
AGTGGACGTCCGTAAGAGTGGACGTCCGTG|TAAAATACCAATAAAGCGCCACAAGAGCCG
CCTGGGTAGCCTAAGTCGCTGGATGGAAGG|ATTGAGCAGATACGACAAGAGTGGACGTCC
AGGCTCGCTCGGTAGCTTGGCAGATACAGC|CATGCCACTGCGTGCCTCTTCGGTCGAAAG
TGTTCTCGCAAGGTCTAAAAGAGTGGACGT|ACACATAACATCTATCGGAATGCCTAAAGA
GACGTCCGTGCACAAGACAGTATAAATGGG|TCACTTATTTGGTCGGTTCGTAGGGACACC
CGTGCACAAGACAGTATTGCGTATTTGCGA|CTCTCCTTTGAGTGAGCAAGCACCCTTACA
TGGACGTCCGTGCACAAGACAGTATTTCGT|CTAAAGAGTGGACGTCCGTGAAGAGTGGAC
ACTGGCAGTGACAGTTAATAATCGACCACG|GCTACTTGACTTTACGGAGAAAGAGTGGAC
CAGGCGATAAAGAGTGGACGTCCGTGCACA|CCACGCTGTTGTCTTAGTCAAAACAGAGCA
CGGGCTATTCTGAACACTGGCATAGCCTTA|GCATCGGAACACTCGGAGTGGGACCAAAGC
CACAAGACAGTATTACAGCCAGCCCGATAT|GACAGTATAAATGGGTGACGGTAAAGACGT
GTCGTCTAAAATACCAATAAAGCGCCACAA|TCGTTAAGTTAAGGGCATTCTGTACAGGAA
TATTCTGAACACTGGCATAGCCTTATTCGA|GGAACACTCGGAGTGGGACCAAAGCGAAAG
ACAAGACAGTATCATGGCACGAAACTCACG|GGACGTCCGTGCACAAGACAGTATGTATAC
AGGTCATGCCACTGCGTGCCTCTTCGGTCG|AAGAGTGGACGTCCGTGCACAAGACAGTAT
AGACAGTATGTATACTTTATCTAAGTTATT|GCCACAAAGAGTGGACGTCCGTGCACAAGA
ACGTCCGTGCACAAGACAGTATTTCGTGAC|AAGAGTGGACGTCCGTGAAGAGTGGACGTC
TGGCACGAAACTCACGCGTAGTTCCTACCC|AAGACAGTATGTATACTTTATCTAAGTTAT
CGTCCGTGCACAAGACAGTATCGAAGCTAT|TGCACAAGACAGTATACCTTCGCTCAGGGA
TAATCGTTTAAGAGTGGACGTCCGTGCACA|TATCGGTCTAAAAAATTAGCGGTATTAGCA
CGTGCACAAGACAGTATAAATGGGTGACGG|ATTTGGTCGGTTCGTAGGGACACCAGAGCA
GAGTCTCATAGTACTTACAGGCGATAAAGA|TGACAGTTAATAATCGACCACGCTGTTGTC
TGCGTCCTGAGGACCTATCGTTCCCGCTAC|GTGGACGTCCGTGCACAAGACAGTATTACA
CGCTACTTGACTTTACGGAGAAAGAGTGGA|ATTACAGCCAGCCCGATATTTGCCCTTAAC
ACCTCCGCTGGTTGGGAGGTTATTCGTTAA|TGTGCAGTTGTCGACATACTTACAGCGTGC
TATGCACAAGACAGTATCGGTCTAAAAAAT|AGTACTTACAGGCGATAAAGAGTGGACGTC
GCATTCTGTACAGGAACTGGCAGTGACAGT|GGACCTATCGTTCCCGCTACTTGACTTTAC
GAGTGAGCAAGCACCCTTACATGAGGTCAT|GGCAGATTCAGGATTTTCTAGGTAAGAGTG
AGTATAGAGTGGACGTCCGTGCACAAGACA|GTCGCAGTAATCGTTTAAGAGTGGACGTCC
GTTATTCGTTAAGTTAAGGGCATTCTGTAC|CTTACAGCGTGCGTCCTGAGGACCTATCGT
GAGTGGACGTCCGTGCACAAGACAGTATCG|TCTTAGTCAAAACAGAGCACGCTTCAAAAG
AGTCAAAACAGAGCACGCTTCAAAAGAACG|AAGACAGTATTGCGTATTTGCGAAAGGGTA
GGACGTCCGTGAAGAGTGGACGTCCGTGCA|GCTGGATGGAAGGGGGGCATATATAGCGAA
GTCGAAAGAGTGGACGTCCGTGCACAAGAC|GTATCGAAGCTATCACTTATTTGGTCGGTT
TAGTCAAAACAGAGCACGCTTCAAAAGAAC|CAAGACAGTATTGCGTATTTGCGAAAGGGT
GATTCAGGATTTTCTAGGTAAGAGTGGACG|TGACGCAAATGAAAAGAGTGGACGTCCGTG
ATCGTTCCCGCTACTTGACTTTACGGAGAA|AAGACAGTATTACAGCCAGCCCGATATTTG
CCTTACATGAGGTCATGCCACTGCGTGCCT|TTTCTAGGTAAGAGTGGACGTCCGTGCACA
CGTGCACAAGACAGTATGCACAAGACAGTA|GCCGGGAGTCTCATAGTACTTACAGGCGAT
TACTTTATCTAAGTTATTGAGCAGATACGA|GGACGTCCGTGCACAAGACAGTATATGAGT
CTTACAGGCGATAAAGAGTGGACGTCCGTG|TCGACCACGCTGTTGTCTTAGTCAAAACAG
CCGTGCACAAGACAGTATGTATACTTTATC|GTATTAGCAGCCACAAAGAGTGGACGTCCG
TCGAAAGAGTGGACGTCCGTGCACAAGACA|TATCGAAGCTATCACTTATTTGGTCGGTTC
GAGCACGCTTCAAAAGAACGCCATGGTATG|TGCGTATTTGCGAAAGGGTAGGCTCGCTCG
CCTACCCTGGGTAGCCTAAGTCGCTGGATG|AAGTTATTGAGCAGATACGACAAGAGTGGA
GAGTGGAAGGCCGACCTCCGCTGGTTGGGA|GAACGCCATGGTATGTGCAGTTGTCGACAT
TGCGAAAGGGTAGGCTCGCTCGGTAGCTTG|TTACATGAGGTCATGCCACTGCGTGCCTCT
GGACGTCCGTGCACAAGACAGTATCACAAG|CATATATAGCGAAGGAAAAAGCTCCGACCT
GTGCACAAGACAGTATAAATGGGTGACGGT|TTTGGTCGGTTCGTAGGGACACCAGAGCAA
GTGGACGTCCGTGAAGAGTGGACGTCCGTG|TCGCTGGATGGAAGGGGGGCATATATAGCG
GCTATCACTTATTTGGTCGGTTCGTAGGGA|AGGGATGGCACAAAGGTGCGTAGGGTTGAC
GACAGTATCACAAGACAGTATAGAGTGGAC|AAAAGCTCCGACCTGCGTCGCAGTAATCGT
AGAAAGAGTGGACGTCCGTGCACAAGACAG|TTTGCCCTTAACGCACCTCTCCTTTGAGTG
AAATGATCAGTCCACTGATACAATCCGGCC|GACGTCCGTGCACAAGACAGTATGTCCGGT
TCCGGCCACACTGTTCTCGCAAGGTCTAAA|GTCCGGTTAAAACACATAACATCTATCGGA
ACTGTTCTCGCAAGGTCTAAAAGAGTGGAC|AAACACATAACATCTATCGGAATGCCTAAA
TCTATCGGAATGCCTAAAGAGTGGACGTCC|CCTACCCTGGGTAGCCTAAGTCGCTGGATG
ACGTCCGTGCACAAGACAGTATAAATGGGT|CACTTATTTGGTCGGTTCGTAGGGACACCA
CAAGACAGTATCGGTCTAAAAAATTAGCGG|TACAGGCGATAAAGAGTGGACGTCCGTGCA
CAGTATGTCCGGTTAAAACACATAACATCT|ATCATGGCACGAAACTCACGCGTAGTTCCT
CCGTGCACAAGACAGTATTTCGTGACGGCA|GTGGACGTCCGTGAAGAGTGGACGTCCGTG
GCCCTTAACGCACCTCTCCTTTGAGTGAGC|CTGGAAACTTCAGGAAATTCGTGGCAGATT
GTCCGTGCACAAGACAGTATGTATACTTTA|CGGTATTAGCAGCCACAAAGAGTGGACGTC
CCGATATTTGCCCTTAACGCACCTCTCCTT|AAGACGTACCTGGAAACTTCAGGAAATTCG
TATTCGTTAAGTTAAGGGCATTCTGTACAG|TACAGCGTGCGTCCTGAGGACCTATCGTTC
TCGGAATGCCTAAAGAGTGGACGTCCGTGA|CCCTGGGTAGCCTAAGTCGCTGGATGGAAG
ACAGAGCACGCTTCAAAAGAACGCCATGGT|TATTGCGTATTTGCGAAAGGGTAGGCTCGC
CCGTGCACAAGACAGTATTGCGTATTTGCG|CCTCTCCTTTGAGTGAGCAAGCACCCTTAC
TGCCTAAAGAGTGGACGTCCGTGAAGAGTG|GTAGCCTAAGTCGCTGGATGGAAGGGGGGC
AGACAGTATAAATGGGTGACGGTAAAGACG|GGTTCGTAGGGACACCAGAGCAATTCATGT
GTCCGTGCACAAGACAGTATGCACAAGACA|AGAGCCGGGAGTCTCATAGTACTTACAGGC
CGAATATAAATGATCAGTCCACTGATACAA|AAGAGTGGACGTCCGTGCACAAGACAGTAT
CAAGACAGTATCGAAGCTATCACTTATTTG|AGTATACCTTCGCTCAGGGATGGCACAAAG
TACAGGCGATAAAGAGTGGACGTCCGTGCA|GACCACGCTGTTGTCTTAGTCAAAACAGAG
AAAAGAACGCCATGGTATGTGCAGTTGTCG|GAAAGGGTAGGCTCGCTCGGTAGCTTGGCA
TATCTAAGTTATTGAGCAGATACGACAAGA|TCCGTGCACAAGACAGTATATGAGTCGTCT
TTATTCGAATATAAATGATCAGTCCACTGA|AGCGAAAGAGTGGACGTCCGTGCACAAGAC
AGTATTGCGTATTTGCGAAAGGGTAGGCTC|TGAGCAAGCACCCTTACATGAGGTCATGCC
GGACGTCCGTGCACAAGACAGTATTTCGTG|TAAAGAGTGGACGTCCGTGAAGAGTGGACG
CCGCTGGTTGGGAGGTTATTCGTTAAGTTA|CAGTTGTCGACATACTTACAGCGTGCGTCC
TTCAGGAAATTCGTGGCAGATTCAGGATTT|GATAAAACGATAGCACGTTGACGCAAATGA
TCGACCACGCTGTTGTCTTAGTCAAAACAG|AGAGTGGACGTCCGTGCACAAGACAGTATT
AGACAGTATCGGTCTAAAAAATTAGCGGTA|CAGGCGATAAAGAGTGGACGTCCGTGCACA
GCACCCTTACATGAGGTCATGCCACTGCGT|GGATTTTCTAGGTAAGAGTGGACGTCCGTG
CGTAAGAGTGGACGTCCGTGCACAAGACAG|GAGTGGACGTCCGTGCACAAGACAGTATAA
GGCCACACTGTTCTCGCAAGGTCTAAAAGA|CGGTTAAAACACATAACATCTATCGGAATG
AAGCTATCACTTATTTGGTCGGTTCGTAGG|TCAGGGATGGCACAAAGGTGCGTAGGGTTG
AAAACAGAGCACGCTTCAAAAGAACGCCAT|CAGTATTGCGTATTTGCGAAAGGGTAGGCT
CTCTCCTTTGAGTGAGCAAGCACCCTTACA|GAAATTCGTGGCAGATTCAGGATTTTCTAG
GTTGTCTTAGTCAAAACAGAGCACGCTTCA|CCGTGCACAAGACAGTATTGCGTATTTGCG
GACGTCCGTGCACAAGACAGTATCGAGTGG|GTCAAAACAGAGCACGCTTCAAAAGAACGC
ATCGTTTAAGAGTGGACGTCCGTGCACAAG|TCGGTCTAAAAAATTAGCGGTATTAGCAGC
CATAACATCTATCGGAATGCCTAAAGAGTG|CGTAGTTCCTACCCTGGGTAGCCTAAGTCG
ACAAGACAGTATAGAGTGGACGTCCGTGCA|GACCTGCGTCGCAGTAATCGTTTAAGAGTG
GACGTCCGTGCACAAGACAGTATGTATACT|TAGCGGTATTAGCAGCCACAAAGAGTGGAC
GAGCAAGCACCCTTACATGAGGTCATGCCA|GATTCAGGATTTTCTAGGTAAGAGTGGACG
ATAAAGCGCCACAAGAGCCGGGAGTCTCAT|ATTCTGTACAGGAACTGGCAGTGACAGTTA
CCTATCGTTCCCGCTACTTGACTTTACGGA|CACAAGACAGTATTACAGCCAGCCCGATAT
TTACAGGCGATAAAGAGTGGACGTCCGTGC|CGACCACGCTGTTGTCTTAGTCAAAACAGA
TGAGCAAGCACCCTTACATGAGGTCATGCC|AGATTCAGGATTTTCTAGGTAAGAGTGGAC
GTGCACAAGACAGTATGTCCGGTTAAAACA|ACAAGACAGTATCATGGCACGAAACTCACG
TTATTGAGCAGATACGACAAGAGTGGACGT|CAAGACAGTATATGAGTCGTCTAAAATACC
CTCGCAAGGTCTAAAAGAGTGGACGTCCGT|ATAACATCTATCGGAATGCCTAAAGAGTGG
CCACTGCGTGCCTCTTCGGTCGAAAGAGTG|ACGTCCGTGCACAAGACAGTATCGAAGCTA
GCGTCGCAGTAATCGTTTAAGAGTGGACGT|ACAAGACAGTATCGGTCTAAAAAATTAGCG
GTGGACGTCCGTGCACAAGACAGTATAAAT|CTATCACTTATTTGGTCGGTTCGTAGGGAC
AACACATAACATCTATCGGAATGCCTAAAG|CACGCGTAGTTCCTACCCTGGGTAGCCTAA
GGAAAAAGCTCCGACCTGCGTCGCAGTAAT|TGCACAAGACAGTATGCACAAGACAGTATC
GTAAGAGTGGACGTCCGTGCACAAGACAGT|TAAAGCGCCACAAGAGCCGGGAGTCTCATA
GACTTTACGGAGAAAGAGTGGACGTCCGTG|CAGCCCGATATTTGCCCTTAACGCACCTCT
GAACACTGGCATAGCCTTATTCGAATATAA|CTCGGAGTGGGACCAAAGCGAAAGAGTGGA
GGACGTCCGTAAGAGTGGACGTCCGTGCAC|AATACCAATAAAGCGCCACAAGAGCCGGGA
CAGCCAGCCCGATATTTGCCCTTAACGCAC|TGACGGTAAAGACGTACCTGGAAACTTCAG
CACAAGACAGTATCACAAGACAGTATAGAG|AAGGAAAAAGCTCCGACCTGCGTCGCAGTA
GGTTCGTAGGGACACCAGAGCAATTCATGT|CGTAGGGTTGACGACGTAAGGTTACTCCTC
GGTTGGGAGGTTATTCGTTAAGTTAAGGGC|GTCGACATACTTACAGCGTGCGTCCTGAGG
AGACAGTATTACAGCCAGCCCGATATTTGC|GTATAAATGGGTGACGGTAAAGACGTACCT
CCTTAACGCACCTCTCCTTTGAGTGAGCAA|GGAAACTTCAGGAAATTCGTGGCAGATTCA
AGAGTGGACGTCCGTGCACAAGACAGTATT|CCCTTAACGCACCTCTCCTTTGAGTGAGCA
TATTCGAATATAAATGATCAGTCCACTGAT|GCGAAAGAGTGGACGTCCGTGCACAAGACA
GACAGTATGCACAAGACAGTATCGGTCTAA|CTCATAGTACTTACAGGCGATAAAGAGTGG
ACAGGCGATAAAGAGTGGACGTCCGTGCAC|ACCACGCTGTTGTCTTAGTCAAAACAGAGC
CACGAAACTCACGCGTAGTTCCTACCCTGG|ACAGTATGTATACTTTATCTAAGTTATTGA
CGACCTCCGCTGGTTGGGAGGTTATTCGTT|TATGTGCAGTTGTCGACATACTTACAGCGT
AGACAGTATGTCCGGTTAAAACACATAACA|AGTATCATGGCACGAAACTCACGCGTAGTT
CGAAAGAGTGGACGTCCGTGCACAAGACAG|ATCGAAGCTATCACTTATTTGGTCGGTTCG
TAACGCACCTCTCCTTTGAGTGAGCAAGCA|AACTTCAGGAAATTCGTGGCAGATTCAGGA
TCGTCTAAAATACCAATAAAGCGCCACAAG|CGTTAAGTTAAGGGCATTCTGTACAGGAAC
AGTTAAGGGCATTCTGTACAGGAACTGGCA|CGTCCTGAGGACCTATCGTTCCCGCTACTT
ATGAGGTCATGCCACTGCGTGCCTCTTCGG|GGTAAGAGTGGACGTCCGTGCACAAGACAG
AGCGAAGGAAAAAGCTCCGACCTGCGTCGC|CGTCCGTGCACAAGACAGTATGCACAAGAC
AAGCGAAAGAGTGGACGTCCGTGCACAAGA|TATAGAGTGGACGTCCGTGCACAAGACAGT
AGTGGACGTCCGTGCACAAGACAGTATGTA|AAATTAGCGGTATTAGCAGCCACAAAGAGT
AAGAGTGGACGTCCGTGCACAAGACAGTAT|GAAGCTATCACTTATTTGGTCGGTTCGTAG
ATATAAATGATCAGTCCACTGATACAATCC|AGTGGACGTCCGTGCACAAGACAGTATGTC
GAAAGGGTAGGCTCGCTCGGTAGCTTGGCA|CATGAGGTCATGCCACTGCGTGCCTCTTCG
ATAATCGACCACGCTGTTGTCTTAGTCAAA|AGAAAGAGTGGACGTCCGTGCACAAGACAG
GTTGTCGACATACTTACAGCGTGCGTCCTG|CTTGGCAGATACAGCGTAAGAGTGGACGTC
GACAGTATGTCCGGTTAAAACACATAACAT|GTATCATGGCACGAAACTCACGCGTAGTTC
GCACAAGACAGTATCATGGCACGAAACTCA|GTGGACGTCCGTGCACAAGACAGTATGTAT
CGGTCTAAAAAATTAGCGGTATTAGCAGCC|AAGAGTGGACGTCCGTGCACAAGACAGTAT
TCTTAGTCAAAACAGAGCACGCTTCAAAAG|GCACAAGACAGTATTGCGTATTTGCGAAAG
GTTAATAATCGACCACGCTGTTGTCTTAGT|ACGGAGAAAGAGTGGACGTCCGTGCACAAG
AGACAGTATGCACAAGACAGTATCGGTCTA|TCTCATAGTACTTACAGGCGATAAAGAGTG
ATCGGAATGCCTAAAGAGTGGACGTCCGTG|ACCCTGGGTAGCCTAAGTCGCTGGATGGAA
CACTCGGAGTGGGACCAAAGCGAAAGAGTG|ACAGTATCACAAGACAGTATAGAGTGGACG
AATTCGTGGCAGATTCAGGATTTTCTAGGT|CGATAGCACGTTGACGCAAATGAAAAGAGT
AGACAGTATTGCGTATTTGCGAAAGGGTAG|TGAGTGAGCAAGCACCCTTACATGAGGTCA
AAAGAGTGGACGTCCGTGAAGAGTGGACGT|CTAAGTCGCTGGATGGAAGGGGGGCATATA
CCACAAGAGCCGGGAGTCTCATAGTACTTA|CAGGAACTGGCAGTGACAGTTAATAATCGA
ACAGTTAATAATCGACCACGCTGTTGTCTT|TTTACGGAGAAAGAGTGGACGTCCGTGCAC
TCGCTCGGTAGCTTGGCAGATACAGCGTAA|CCACTGCGTGCCTCTTCGGTCGAAAGAGTG
AGTTATTGAGCAGATACGACAAGAGTGGAC|CACAAGACAGTATATGAGTCGTCTAAAATA
AGTCGTCTAAAATACCAATAAAGCGCCACA|TTCGTTAAGTTAAGGGCATTCTGTACAGGA
GCAGATACAGCGTAAGAGTGGACGTCCGTG|TCGGTCGAAAGAGTGGACGTCCGTGCACAA
CGTCCGTGCACAAGACAGTATGCACAAGAC|AAGAGCCGGGAGTCTCATAGTACTTACAGG
CATATATAGCGAAGGAAAAAGCTCCGACCT|GAGTGGACGTCCGTGCACAAGACAGTATGC
AGAGTGGACGTCCGTGCACAAGACAGTATG|AGCGCCACAAGAGCCGGGAGTCTCATAGTA
GCACAAGACAGTATAAATGGGTGACGGTAA|TGGTCGGTTCGTAGGGACACCAGAGCAATT
GCGGTATTAGCAGCCACAAAGAGTGGACGT|TGCACAAGACAGTATCGAGTGGAAGGCCGA
TAAGTTAAGGGCATTCTGTACAGGAACTGG|TGCGTCCTGAGGACCTATCGTTCCCGCTAC
AACGCCATGGTATGTGCAGTTGTCGACATA|GGTAGGCTCGCTCGGTAGCTTGGCAGATAC
AGTATGTCCGGTTAAAACACATAACATCTA|TCATGGCACGAAACTCACGCGTAGTTCCTA
CGAAGCTATCACTTATTTGGTCGGTTCGTA|GCTCAGGGATGGCACAAAGGTGCGTAGGGT
TAAGAGTGGACGTCCGTGCACAAGACAGTA|AAAGCGCCACAAGAGCCGGGAGTCTCATAG
GGGGGCATATATAGCGAAGGAAAAAGCTCC|CGTAAGAGTGGACGTCCGTGCACAAGACAG
ACGGAGAAAGAGTGGACGTCCGTGCACAAG|GATATTTGCCCTTAACGCACCTCTCCTTTG
TTATTTGGTCGGTTCGTAGGGACACCAGAG|CACAAAGGTGCGTAGGGTTGACGACGTAAG
AAAGAGTGGACGTCCGTGCACAAGACAGTA|AGTGGAAGGCCGACCTCCGCTGGTTGGGAG
AGAGTGGACGTCCGTGCACAAGACAGTATC|GACGTCCGTGCACAAGACAGTATACCTTCG
AAAGAACGCCATGGTATGTGCAGTTGTCGA|AAAGGGTAGGCTCGCTCGGTAGCTTGGCAG
GCACAAGACAGTATATGAGTCGTCTAAAAT|CGCTGGTTGGGAGGTTATTCGTTAAGTTAA
ACGTCCGTGCACAAGACAGTATGTATACTT|AGCGGTATTAGCAGCCACAAAGAGTGGACG
AGACAGTATCGAGTGGAAGGCCGACCTCCG|CGCTTCAAAAGAACGCCATGGTATGTGCAG
ATGATCAGTCCACTGATACAATCCGGCCAC|CGTCCGTGCACAAGACAGTATGTCCGGTTA
GTGCACAAGACAGTATGTATACTTTATCTA|ATTAGCAGCCACAAAGAGTGGACGTCCGTG
ATTCAGGATTTTCTAGGTAAGAGTGGACGT|GACGCAAATGAAAAGAGTGGACGTCCGTGC
TCGGTTCGTAGGGACACCAGAGCAATTCAT|TGCGTAGGGTTGACGACGTAAGGTTACTCC
AAGACAGTATCGAAGCTATCACTTATTTGG|GTATACCTTCGCTCAGGGATGGCACAAAGG
TTCTAGGTAAGAGTGGACGTCCGTGCACAA|AAAAGAGTGGACGTCCGTGCACAAGACAGT
CTATTCTGAACACTGGCATAGCCTTATTCG|CGGAACACTCGGAGTGGGACCAAAGCGAAA
TCCGTGAAGAGTGGACGTCCGTGCACAAGA|ATGGAAGGGGGGCATATATAGCGAAGGAAA
TCATAGTACTTACAGGCGATAAAGAGTGGA|GTTAATAATCGACCACGCTGTTGTCTTAGT
ACAAGACAGTATGTATACTTTATCTAAGTT|GCAGCCACAAAGAGTGGACGTCCGTGCACA
CAAAACAGAGCACGCTTCAAAAGAACGCCA|ACAGTATTGCGTATTTGCGAAAGGGTAGGC
TCCGTGCACAAGACAGTATAAATGGGTGAC|TTATTTGGTCGGTTCGTAGGGACACCAGAG
ATCGAGTGGAAGGCCGACCTCCGCTGGTTG|AAAGAACGCCATGGTATGTGCAGTTGTCGA
GTCTAAAAAATTAGCGGTATTAGCAGCCAC|GAGTGGACGTCCGTGCACAAGACAGTATCG
CTATCACTTATTTGGTCGGTTCGTAGGGAC|GGGATGGCACAAAGGTGCGTAGGGTTGACG